Data;idUF;sigla;EXP;IMP;BalancaUF
15/01/2000;12;AC;75192;93749;-18557
15/01/2000;27;AL;25055929;5314818;19741111
15/01/2000;16;AP;2624561;1654433;970128
15/01/2000;13;AM;41029862;277873355;-236843493
15/01/2000;29;BA;136945740;127062827;9882913
15/01/2000;23;CE;32361900;47904749;-15542849
15/01/2000;53;DF;301949;46285222;-45983273
15/01/2000;32;ES;209439751;153437675;56002076
15/01/2000;52;GO;21168034;26855674;-5687640
15/01/2000;21;MA;69813594;13681979;56131615
15/01/2000;51;MT;15259344;6234143;9025201
15/01/2000;50;MS;7000549;10522485;-3521936
15/01/2000;31;MG;530233434;161495295;368738139
15/01/2000;15;PA;180552055;20433807;160118248
15/01/2000;25;PB;7450773;6573756;877017
15/01/2000;41;PR;215246267;234087981;-18841714
15/01/2000;26;PE;19845220;55758451;-35913231
15/01/2000;22;PI;2710067;831111;1878956
15/01/2000;33;RJ;127023442;354623999;-227600557
15/01/2000;24;RN;9888057;5892282;3995775
15/01/2000;43;RS;339501859;247064215;92437644
15/01/2000;11;RO;3930651;187701;3742950
15/01/2000;14;RR;146903;185641;-38738
15/01/2000;42;SC;157856916;67788936;90067980
15/01/2000;35;SP;1235978059;1685606705;-449628646
15/01/2000;28;SE;2231974;4994557;-2762583
15/01/2000;17;TO;1013100;1231730;-218630
15/02/2000;12;AC;7483;51685;-44202
15/02/2000;27;AL;13964859;5813767;8151092
15/02/2000;16;AP;5510439;265606;5244833
15/02/2000;13;AM;50501936;226868401;-176366465
15/02/2000;29;BA;169765913;142960816;26805097
15/02/2000;23;CE;36820620;45387178;-8566558
15/02/2000;53;DF;52859;32215913;-32163054
15/02/2000;32;ES;208967378;160521816;48445562
15/02/2000;52;GO;32469069;24579038;7890031
15/02/2000;21;MA;46242188;17356346;28885842
15/02/2000;51;MT;34273713;2393150;31880563
15/02/2000;50;MS;17640846;8668967;8971879
15/02/2000;31;MG;514747426;213774396;300973030
15/02/2000;15;PA;212517248;19207479;193309769
15/02/2000;25;PB;4503988;15061932;-10557944
15/02/2000;41;PR;236541374;272027661;-35486287
15/02/2000;26;PE;30331315;77678405;-47347090
15/02/2000;22;PI;4640808;1167579;3473229
15/02/2000;33;RJ;131768143;405034914;-273266771
15/02/2000;24;RN;9964081;4205969;5758112
15/02/2000;43;RS;351771973;272790348;78981625
15/02/2000;11;RO;4144836;233868;3910968
15/02/2000;14;RR;184285;257443;-73158
15/02/2000;42;SC;215486765;81621555;133865210
15/02/2000;35;SP;1636188901;2002855014;-366666113
15/02/2000;28;SE;990898;9684788;-8693890
15/02/2000;17;TO;88910;100556;-11646
15/03/2000;12;AC;157726;17145;140581
15/03/2000;27;AL;6480592;5364962;1115630
15/03/2000;16;AP;2097462;5207907;-3110445
15/03/2000;13;AM;49074256;295207219;-246132963
15/03/2000;29;BA;148248277;196064587;-47816310
15/03/2000;23;CE;43661172;78555912;-34894740
15/03/2000;53;DF;186357;32851161;-32664804
15/03/2000;32;ES;288137580;188288642;99848938
15/03/2000;52;GO;36133297;22615103;13518194
15/03/2000;21;MA;68128711;27661458;40467253
15/03/2000;51;MT;52852720;5118592;47734128
15/03/2000;50;MS;16589533;8471916;8117617
15/03/2000;31;MG;554351264;221133490;333217774
15/03/2000;15;PA;202234460;19568276;182666184
15/03/2000;25;PB;8000462;16008321;-8007859
15/03/2000;41;PR;308113618;303560110;4553508
15/03/2000;26;PE;20406590;77039110;-56632520
15/03/2000;22;PI;3115814;556530;2559284
15/03/2000;33;RJ;143873503;494554998;-350681495
15/03/2000;24;RN;15542504;3938844;11603660
15/03/2000;43;RS;415373847;357117320;58256527
15/03/2000;11;RO;4736372;186075;4550297
15/03/2000;14;RR;185209;252077;-66868
15/03/2000;42;SC;250667453;83007360;167660093
15/03/2000;35;SP;1622522652;1992919942;-370397290
15/03/2000;28;SE;4710623;5898046;-1187423
15/03/2000;17;TO;51345;3191252;-3139907
15/04/2000;12;AC;122901;4916423;-4793522
15/04/2000;27;AL;11545983;3665016;7880967
15/04/2000;16;AP;2569560;413164;2156396
15/04/2000;13;AM;63681477;288079397;-224397920
15/04/2000;29;BA;122249505;195253175;-73003670
15/04/2000;23;CE;36821621;41540203;-4718582
15/04/2000;53;DF;205793;36568504;-36362711
15/04/2000;32;ES;192867233;145852404;47014829
15/04/2000;52;GO;31277911;20520138;10757773
15/04/2000;21;MA;62879654;12102358;50777296
15/04/2000;51;MT;113363471;4805941;108557530
15/04/2000;50;MS;12411196;7760479;4650717
15/04/2000;31;MG;531028490;161976033;369052457
15/04/2000;15;PA;194510292;9486774;185023518
15/04/2000;25;PB;6548384;7228791;-680407
15/04/2000;41;PR;375305786;377198400;-1892614
15/04/2000;26;PE;16401918;54518720;-38116802
15/04/2000;22;PI;4183241;1214979;2968262
15/04/2000;33;RJ;135656798;289508546;-153851748
15/04/2000;24;RN;8463405;3824580;4638825
15/04/2000;43;RS;464741682;247501145;217240537
15/04/2000;11;RO;4211735;283908;3927827
15/04/2000;14;RR;256915;272292;-15377
15/04/2000;42;SC;213969892;73122444;140847448
15/04/2000;35;SP;1480652066;1991416684;-510764618
15/04/2000;28;SE;2618072;8568268;-5950196
15/04/2000;17;TO;43911;447494;-403583
15/05/2000;12;AC;104928;43014;61914
15/05/2000;27;AL;7353991;8200848;-846857
15/05/2000;16;AP;3198516;2075755;1122761
15/05/2000;13;AM;50819830;317735374;-266915544
15/05/2000;29;BA;190619745;210937379;-20317634
15/05/2000;23;CE;48220707;76821907;-28601200
15/05/2000;53;DF;66547;32669093;-32602546
15/05/2000;32;ES;264906817;152857340;112049477
15/05/2000;52;GO;58186808;23921788;34265020
15/05/2000;21;MA;51871944;72117371;-20245427
15/05/2000;51;MT;115635566;2560041;113075525
15/05/2000;50;MS;29973284;11555143;18418141
15/05/2000;31;MG;622617117;240642040;381975077
15/05/2000;15;PA;220415124;16572736;203842388
15/05/2000;25;PB;7868459;13485042;-5616583
15/05/2000;41;PR;471417608;388860608;82557000
15/05/2000;26;PE;21223192;88814221;-67591029
15/05/2000;22;PI;4605811;856805;3749006
15/05/2000;33;RJ;167431349;454774624;-287343275
15/05/2000;24;RN;12542945;8378924;4164021
15/05/2000;43;RS;472327914;289749230;182578684
15/05/2000;11;RO;4461915;116490;4345425
15/05/2000;14;RR;241937;456953;-215016
15/05/2000;42;SC;231108559;82078698;149029861
15/05/2000;35;SP;1659470165;2180041343;-520571178
15/05/2000;28;SE;832518;7999785;-7167267
15/05/2000;17;TO;110836;1437786;-1326950
15/06/2000;12;AC;74112;21258;52854
15/06/2000;27;AL;2238814;3429174;-1190360
15/06/2000;16;AP;1333781;1782813;-449032
15/06/2000;13;AM;72352758;299566007;-227213249
15/06/2000;29;BA;151484479;165802607;-14318128
15/06/2000;23;CE;43705736;50553895;-6848159
15/06/2000;53;DF;185937;29655819;-29469882
15/06/2000;32;ES;231250540;199617199;31633341
15/06/2000;52;GO;58172724;31441311;26731413
15/06/2000;21;MA;76090395;30523130;45567265
15/06/2000;51;MT;131194926;7586048;123608878
15/06/2000;50;MS;25830535;10628050;15202485
15/06/2000;31;MG;629853233;217129276;412723957
15/06/2000;15;PA;148395919;17387509;131008410
15/06/2000;25;PB;5983627;16288634;-10305007
15/06/2000;41;PR;400686701;401074985;-388284
15/06/2000;26;PE;15363788;54949067;-39585279
15/06/2000;22;PI;3983080;916366;3066714
15/06/2000;33;RJ;145049610;385763834;-240714224
15/06/2000;24;RN;10857336;3914880;6942456
15/06/2000;43;RS;573351406;390136090;183215316
15/06/2000;11;RO;5027585;332713;4694872
15/06/2000;14;RR;287389;246839;40550
15/06/2000;42;SC;231712811;74821619;156891192
15/06/2000;35;SP;1767670460;2189684938;-422014478
15/06/2000;28;SE;3960346;7158303;-3197957
15/06/2000;17;TO;2849380;288042;2561338
15/07/2000;12;AC;83829;363353;-279524
15/07/2000;27;AL;29205691;5275600;23930091
15/07/2000;16;AP;2933409;2978064;-44655
15/07/2000;13;AM;73811422;341032282;-267220860
15/07/2000;29;BA;246836769;152154379;94682390
15/07/2000;23;CE;41621537;78930638;-37309101
15/07/2000;53;DF;90315;73755440;-73665125
15/07/2000;32;ES;275299903;215020930;60278973
15/07/2000;52;GO;55414980;29264607;26150373
15/07/2000;21;MA;44342054;51134454;-6792400
15/07/2000;51;MT;136354856;6540797;129814059
15/07/2000;50;MS;22560482;13753480;8807002
15/07/2000;31;MG;549962704;241454175;308508529
15/07/2000;15;PA;193164258;27825364;165338894
15/07/2000;25;PB;3703164;19069655;-15366491
15/07/2000;41;PR;440592824;419231859;21360965
15/07/2000;26;PE;24940886;83348947;-58408061
15/07/2000;22;PI;12431753;899281;11532472
15/07/2000;33;RJ;178600514;420315994;-241715480
15/07/2000;24;RN;9646920;3567444;6079476
15/07/2000;43;RS;604165103;312515437;291649666
15/07/2000;11;RO;4424596;278416;4146180
15/07/2000;14;RR;258824;268459;-9635
15/07/2000;42;SC;230130568;87693407;142437161
15/07/2000;35;SP;1711924406;2272004926;-560080520
15/07/2000;28;SE;6140875;9558313;-3417438
15/07/2000;17;TO;1525006;1500405;24601
15/08/2000;12;AC;27987;29515;-1528
15/08/2000;27;AL;1022824;1972464;-949640
15/08/2000;16;AP;3146023;1229071;1916952
15/08/2000;13;AM;74958155;349635664;-274677509
15/08/2000;29;BA;176002281;184674093;-8671812
15/08/2000;23;CE;49316330;65062306;-15745976
15/08/2000;53;DF;70968;45195531;-45124563
15/08/2000;32;ES;235910148;220388735;15521413
15/08/2000;52;GO;47246761;42365314;4881447
15/08/2000;21;MA;98845142;47067734;51777408
15/08/2000;51;MT;166937783;7009125;159928658
15/08/2000;50;MS;23103666;19180598;3923068
15/08/2000;31;MG;620424156;265262344;355161812
15/08/2000;15;PA;243465915;31858444;211607471
15/08/2000;25;PB;4430317;13506568;-9076251
15/08/2000;41;PR;460488260;502216359;-41728099
15/08/2000;26;PE;18247433;78470464;-60223031
15/08/2000;22;PI;4923828;1395604;3528224
15/08/2000;33;RJ;174532354;470379297;-295846943
15/08/2000;24;RN;12980140;4570621;8409519
15/08/2000;43;RS;630656581;483840340;146816241
15/08/2000;11;RO;5341442;41547762;-36206320
15/08/2000;14;RR;197452;523855;-326403
15/08/2000;42;SC;262500828;94095203;168405625
15/08/2000;35;SP;1846216903;2428617112;-582400209
15/08/2000;28;SE;1741346;9309256;-7567910
15/08/2000;17;TO;1068971;1535442;-466471
15/09/2000;12;AC;116240;115750;490
15/09/2000;27;AL;10782943;6769723;4013220
15/09/2000;16;AP;1109909;2930677;-1820768
15/09/2000;13;AM;65720609;358621685;-292901076
15/09/2000;29;BA;164934625;174683228;-9748603
15/09/2000;23;CE;41180303;55353253;-14172950
15/09/2000;53;DF;51413;51943739;-51892326
15/09/2000;32;ES;250665899;234133152;16532747
15/09/2000;52;GO;76480533;32635413;43845120
15/09/2000;21;MA;56397771;31108331;25289440
15/09/2000;51;MT;64613597;13009558;51604039
15/09/2000;50;MS;21544561;16608953;4935608
15/09/2000;31;MG;544746127;316399580;228346547
15/09/2000;15;PA;225043289;25009790;200033499
15/09/2000;25;PB;4433171;12881369;-8448198
15/09/2000;41;PR;337313342;442398295;-105084953
15/09/2000;26;PE;20423220;99107328;-78684108
15/09/2000;22;PI;3041616;1183150;1858466
15/09/2000;33;RJ;160872409;460869747;-299997338
15/09/2000;24;RN;11768068;8674078;3093990
15/09/2000;43;RS;498017173;338941219;159075954
15/09/2000;11;RO;5238278;449745;4788533
15/09/2000;14;RR;154906;325792;-170886
15/09/2000;42;SC;226161068;92182495;133978573
15/09/2000;35;SP;1790544560;2268927236;-478382676
15/09/2000;28;SE;1871749;6427159;-4555410
15/09/2000;17;TO;54774;1893168;-1838394
15/10/2000;12;AC;307728;85070;222658
15/10/2000;27;AL;20272658;7190827;13081831
15/10/2000;16;AP;1434690;3073607;-1638917
15/10/2000;13;AM;85127472;396335101;-311207629
15/10/2000;29;BA;128841086;225065788;-96224702
15/10/2000;23;CE;37230907;59070185;-21839278
15/10/2000;53;DF;75647;48642763;-48567116
15/10/2000;32;ES;226987790;221724725;5263065
15/10/2000;52;GO;43506263;42766838;739425
15/10/2000;21;MA;35740677;71917290;-36176613
15/10/2000;51;MT;96469858;10108960;86360898
15/10/2000;50;MS;26007019;18323861;7683158
15/10/2000;31;MG;588660345;238189624;350470721
15/10/2000;15;PA;186961898;31260731;155701167
15/10/2000;25;PB;4180769;10861632;-6680863
15/10/2000;41;PR;404117219;466745524;-62628305
15/10/2000;26;PE;19391119;106699331;-87308212
15/10/2000;22;PI;10942252;1910005;9032247
15/10/2000;33;RJ;123776663;409179421;-285402758
15/10/2000;24;RN;14518809;9280221;5238588
15/10/2000;43;RS;485801343;417543646;68257697
15/10/2000;11;RO;5365698;383295;4982403
15/10/2000;14;RR;173807;361065;-187258
15/10/2000;42;SC;223211901;103494205;119717696
15/10/2000;35;SP;1740851221;2327866227;-587015006
15/10/2000;28;SE;1036323;7814163;-6777840
15/10/2000;17;TO;1377919;911840;466079
15/11/2000;12;AC;187746;23290;164456
15/11/2000;27;AL;38016267;5974744;32041523
15/11/2000;16;AP;5374208;3848294;1525914
15/11/2000;13;AM;65822280;398171877;-332349597
15/11/2000;29;BA;136911791;209146622;-72234831
15/11/2000;23;CE;41513026;78084240;-36571214
15/11/2000;53;DF;108679;44252242;-44143563
15/11/2000;32;ES;151713495;246968563;-95255068
15/11/2000;52;GO;52972006;42548349;10423657
15/11/2000;21;MA;77854916;59848938;18005978
15/11/2000;51;MT;65121520;12512606;52608914
15/11/2000;50;MS;26676282;19791447;6884835
15/11/2000;31;MG;536858206;243098512;293759694
15/11/2000;15;PA;239227623;21919769;217307854
15/11/2000;25;PB;11011919;9710214;1301705
15/11/2000;41;PR;380391967;442173969;-61782002
15/11/2000;26;PE;44930283;100574333;-55644050
15/11/2000;22;PI;4415850;1652596;2763254
15/11/2000;33;RJ;137773779;420187318;-282413539
15/11/2000;24;RN;16417605;6177756;10239849
15/11/2000;43;RS;487048275;348305093;138743182
15/11/2000;11;RO;6107505;673544;5433961
15/11/2000;14;RR;255924;195274;60650
15/11/2000;42;SC;228233222;96790744;131442478
15/11/2000;35;SP;1474875171;2323894109;-849018938
15/11/2000;28;SE;1662745;6654694;-4991949
15/11/2000;17;TO;22351;544467;-522116
15/12/2000;12;AC;280117;12360;267757
15/12/2000;27;AL;58410688;7645416;50765272
15/12/2000;16;AP;4666257;2818832;1847425
15/12/2000;13;AM;75144315;276678382;-201534067
15/12/2000;29;BA;169573402;254937528;-85364126
15/12/2000;23;CE;42346541;53097000;-10750459
15/12/2000;53;DF;213665;33983753;-33770088
15/12/2000;32;ES;235610430;252249970;-16639540
15/12/2000;52;GO;31728841;29770731;1958110
15/12/2000;21;MA;64190600;50531125;13659475
15/12/2000;51;MT;40886530;15026084;25860446
15/12/2000;50;MS;23730730;18502715;5228015
15/12/2000;31;MG;481198320;278984804;202213516
15/12/2000;15;PA;193263919;35680738;157583181
15/12/2000;25;PB;9462071;8627668;834403
15/12/2000;41;PR;349288539;443246368;-93957829
15/12/2000;26;PE;32301423;77918730;-45617307
15/12/2000;22;PI;4350683;3255932;1094751
15/12/2000;33;RJ;208973616;470240067;-261266451
15/12/2000;24;RN;16770895;4359239;12411656
15/12/2000;43;RS;447787364;342905865;104881499
15/12/2000;11;RO;6266797;348802;5917995
15/12/2000;14;RR;242625;349661;-107036
15/12/2000;42;SC;238675431;77234410;161441021
15/12/2000;35;SP;1801688954;2111622342;-309933388
15/12/2000;28;SE;1931563;9675994;-7744431
15/12/2000;17;TO;104475;607495;-503020
15/01/2001;12;AC;136717;22275;114442
15/01/2001;27;AL;62764263;8116124;54648139
15/01/2001;16;AP;1197302;2549836;-1352534
15/01/2001;13;AM;46205434;336405522;-290200088
15/01/2001;29;BA;226002508;226777814;-775306
15/01/2001;23;CE;40818734;78431937;-37613203
15/01/2001;53;DF;78898;44147010;-44068112
15/01/2001;32;ES;257022470;213710205;43312265
15/01/2001;52;GO;46192129;39559548;6632581
15/01/2001;21;MA;35779034;89874145;-54095111
15/01/2001;51;MT;49211442;10526596;38684846
15/01/2001;50;MS;29348566;19410863;9937703
15/01/2001;31;MG;558615270;242833586;315781684
15/01/2001;15;PA;206512489;30077341;176435148
15/01/2001;25;PB;10891055;12357490;-1466435
15/01/2001;41;PR;341981932;482811410;-140829478
15/01/2001;26;PE;52593034;111115434;-58522400
15/01/2001;22;PI;3487588;1420052;2067536
15/01/2001;33;RJ;229359754;548726695;-319366941
15/01/2001;24;RN;17788110;9849357;7938753
15/01/2001;43;RS;414277860;300346712;113931148
15/01/2001;11;RO;3683153;510011;3173142
15/01/2001;14;RR;304978;517792;-212814
15/01/2001;42;SC;178892614;86536467;92356147
15/01/2001;35;SP;1496161879;2088744254;-592582375
15/01/2001;28;SE;1909716;8224999;-6315283
15/01/2001;17;TO;1143952;825003;318949
15/02/2001;12;AC;104050;13932;90118
15/02/2001;27;AL;34327500;5606326;28721174
15/02/2001;16;AP;2950939;1046263;1904676
15/02/2001;13;AM;65735974;273501260;-207765286
15/02/2001;29;BA;191408110;218108777;-26700667
15/02/2001;23;CE;40545319;39158867;1386452
15/02/2001;53;DF;18454;20232986;-20214532
15/02/2001;32;ES;142007954;195100312;-53092358
15/02/2001;52;GO;22521891;27232890;-4710999
15/02/2001;21;MA;64378544;9770189;54608355
15/02/2001;51;MT;49128985;2629694;46499291
15/02/2001;50;MS;30400836;18810753;11590083
15/02/2001;31;MG;436933854;182739458;254194396
15/02/2001;15;PA;183298240;21065110;162233130
15/02/2001;25;PB;9121860;4496462;4625398
15/02/2001;41;PR;291115137;364079995;-72964858
15/02/2001;26;PE;28476024;80344905;-51868881
15/02/2001;22;PI;3355453;1716483;1638970
15/02/2001;33;RJ;187717022;398187492;-210470470
15/02/2001;24;RN;22251971;7603980;14647991
15/02/2001;43;RS;400416773;205216688;195200085
15/02/2001;11;RO;3024770;395647;2629123
15/02/2001;14;RR;169402;90795;78607
15/02/2001;42;SC;231027578;72314753;158712825
15/02/2001;35;SP;1460051992;1835769093;-375717101
15/02/2001;28;SE;2292782;7908777;-5615995
15/02/2001;17;TO;49776;250042;-200266
15/03/2001;12;AC;665702;33025;632677
15/03/2001;27;AL;50668510;6323973;44344537
15/03/2001;16;AP;3071048;1045885;2025163
15/03/2001;13;AM;64201673;344126938;-279925265
15/03/2001;29;BA;167132100;211814810;-44682710
15/03/2001;23;CE;43401155;66172095;-22770940
15/03/2001;53;DF;414868;32972814;-32557946
15/03/2001;32;ES;208419998;253784962;-45364964
15/03/2001;52;GO;49323349;40579472;8743877
15/03/2001;21;MA;42122472;90191621;-48069149
15/03/2001;51;MT;122392047;3647038;118745009
15/03/2001;50;MS;34521913;21413541;13108372
15/03/2001;31;MG;587520476;315155091;272365385
15/03/2001;15;PA;230204094;24374011;205830083
15/03/2001;25;PB;8678965;8602492;76473
15/03/2001;41;PR;362022886;445351439;-83328553
15/03/2001;26;PE;27979234;86317500;-58338266
15/03/2001;22;PI;4043467;730419;3313048
15/03/2001;33;RJ;159763623;589892062;-430128439
15/03/2001;24;RN;15282450;10763044;4519406
15/03/2001;43;RS;520046938;315459142;204587796
15/03/2001;11;RO;4221253;218129;4003124
15/03/2001;14;RR;488890;99758;389132
15/03/2001;42;SC;281567648;91510567;190057081
15/03/2001;35;SP;1831094637;2465212682;-634118045
15/03/2001;28;SE;2917661;9768904;-6851243
15/03/2001;17;TO;106299;717991;-611692
15/04/2001;12;AC;534550;49940;484610
15/04/2001;27;AL;24559960;5312816;19247144
15/04/2001;16;AP;3029203;331681;2697522
15/04/2001;13;AM;66940798;314643308;-247702510
15/04/2001;29;BA;190361366;179489500;10871866
15/04/2001;23;CE;42213234;68656596;-26443362
15/04/2001;53;DF;338143;54832608;-54494465
15/04/2001;32;ES;158576872;178063839;-19486967
15/04/2001;52;GO;44710859;31036936;13673923
15/04/2001;21;MA;40123429;47598706;-7475277
15/04/2001;51;MT;90014855;2430840;87584015
15/04/2001;50;MS;30932303;22461779;8470524
15/04/2001;31;MG;510193976;292111051;218082925
15/04/2001;15;PA;168583489;21659159;146924330
15/04/2001;25;PB;8180293;5428769;2751524
15/04/2001;41;PR;514071164;519471292;-5400128
15/04/2001;26;PE;17593385;69196455;-51603070
15/04/2001;22;PI;3762982;1223503;2539479
15/04/2001;33;RJ;200358457;422307642;-221949185
15/04/2001;24;RN;9751609;2963630;6787979
15/04/2001;43;RS;488764330;260078744;228685586
15/04/2001;11;RO;3693199;320249;3372950
15/04/2001;14;RR;456196;186058;270138
15/04/2001;42;SC;267052855;64209244;202843611
15/04/2001;35;SP;1616674163;2028769059;-412094896
15/04/2001;28;SE;933309;7096735;-6163426
15/04/2001;17;TO;897566;208592;688974
15/05/2001;12;AC;717360;16612;700748
15/05/2001;27;AL;7400455;8173116;-772661
15/05/2001;16;AP;3965194;696153;3269041
15/05/2001;13;AM;78857335;315133079;-236275744
15/05/2001;29;BA;224288062;211775635;12512427
15/05/2001;23;CE;44504698;75281275;-30776577
15/05/2001;53;DF;74014;39407515;-39333501
15/05/2001;32;ES;205835393;206230735;-395342
15/05/2001;52;GO;58326805;33213113;25113692
15/05/2001;21;MA;65483231;95405006;-29921775
15/05/2001;51;MT;150147564;7503618;142643946
15/05/2001;50;MS;36396423;22135093;14261330
15/05/2001;31;MG;556957880;292711189;264246691
15/05/2001;15;PA;221731513;29863749;191867764
15/05/2001;25;PB;8370536;11356893;-2986357
15/05/2001;41;PR;558562273;446946169;111616104
15/05/2001;26;PE;18834480;107122661;-88288181
15/05/2001;22;PI;2862563;2107609;754954
15/05/2001;33;RJ;214476426;460855089;-246378663
15/05/2001;24;RN;13733760;7458294;6275466
15/05/2001;43;RS;637687969;266607089;371080880
15/05/2001;11;RO;4405349;444402;3960947
15/05/2001;14;RR;443645;786380;-342735
15/05/2001;42;SC;280016558;75737475;204279083
15/05/2001;35;SP;1836293294;2410703678;-574410384
15/05/2001;28;SE;1587774;13563574;-11975800
15/05/2001;17;TO;710097;1509801;-799704
15/06/2001;12;AC;1169079;21134;1147945
15/06/2001;27;AL;11424317;5039840;6384477
15/06/2001;16;AP;2942930;351733;2591197
15/06/2001;13;AM;61295605;285274998;-223979393
15/06/2001;29;BA;143956061;204456263;-60500202
15/06/2001;23;CE;49320533;40752779;8567754
15/06/2001;53;DF;64258;32522203;-32457945
15/06/2001;32;ES;180095809;203183997;-23088188
15/06/2001;52;GO;72119184;30100738;42018446
15/06/2001;21;MA;58478164;18720700;39757464
15/06/2001;51;MT;147145078;5869502;141275576
15/06/2001;50;MS;58548327;24690759;33857568
15/06/2001;31;MG;434787315;240541189;194246126
15/06/2001;15;PA;159960247;23913712;136046535
15/06/2001;25;PB;8049364;4770738;3278626
15/06/2001;41;PR;507658578;407242758;100415820
15/06/2001;26;PE;15212068;110781498;-95569430
15/06/2001;22;PI;4439939;1023148;3416791
15/06/2001;33;RJ;271012479;654973082;-383960603
15/06/2001;24;RN;12086727;4386664;7700063
15/06/2001;43;RS;631709080;249326442;382382638
15/06/2001;11;RO;3762903;337212;3425691
15/06/2001;14;RR;334387;409258;-74871
15/06/2001;42;SC;261936420;65574741;196361679
15/06/2001;35;SP;1805668300;2126973348;-321305048
15/06/2001;28;SE;778015;6509251;-5731236
15/06/2001;17;TO;141315;624494;-483179
15/07/2001;12;AC;324741;52138;272603
15/07/2001;27;AL;15126448;4269389;10857059
15/07/2001;16;AP;1974735;196128;1778607
15/07/2001;13;AM;84641360;274514871;-189873511
15/07/2001;29;BA;145801065;141953266;3847799
15/07/2001;23;CE;41586751;57201907;-15615156
15/07/2001;53;DF;2819841;61617764;-58797923
15/07/2001;32;ES;188422862;180292037;8130825
15/07/2001;52;GO;54505803;31981164;22524639
15/07/2001;21;MA;53557597;121177222;-67619625
15/07/2001;51;MT;141549724;12549346;129000378
15/07/2001;50;MS;53144383;24592545;28551838
15/07/2001;31;MG;529981569;276921873;253059696
15/07/2001;15;PA;175695687;24255677;151440010
15/07/2001;25;PB;7348964;6256232;1092732
15/07/2001;41;PR;469986838;389133575;80853263
15/07/2001;26;PE;24797166;74025395;-49228229
15/07/2001;22;PI;3521487;1581629;1939858
15/07/2001;33;RJ;241072262;467143282;-226071020
15/07/2001;24;RN;11552550;7586749;3965801
15/07/2001;43;RS;657680726;304415359;353265367
15/07/2001;11;RO;4536959;955538;3581421
15/07/2001;14;RR;390273;93533;296740
15/07/2001;42;SC;244302606;73981686;170320920
15/07/2001;35;SP;1704266221;2298836019;-594569798
15/07/2001;28;SE;2607419;7423146;-4815727
15/07/2001;17;TO;169166;678969;-509803
15/08/2001;12;AC;480830;14580;466250
15/08/2001;27;AL;1817952;3854613;-2036661
15/08/2001;16;AP;3160915;1245294;1915621
15/08/2001;13;AM;90404369;268927628;-178523259
15/08/2001;29;BA;162735107;195616891;-32881784
15/08/2001;23;CE;52041574;42454446;9587128
15/08/2001;53;DF;261764;30954458;-30692694
15/08/2001;32;ES;267310360;228262988;39047372
15/08/2001;52;GO;69317711;33953346;35364365
15/08/2001;21;MA;43154067;38276653;4877414
15/08/2001;51;MT;191596164;20438127;171158037
15/08/2001;50;MS;47814031;41984517;5829514
15/08/2001;31;MG;531444886;326637445;204807441
15/08/2001;15;PA;206676259;21907437;184768822
15/08/2001;25;PB;7495167;10231022;-2735855
15/08/2001;41;PR;553330782;471798058;81532724
15/08/2001;26;PE;17191407;64899949;-47708542
15/08/2001;22;PI;2774615;1134385;1640230
15/08/2001;33;RJ;218014948;565731994;-347717046
15/08/2001;24;RN;14227137;6510415;7716722
15/08/2001;43;RS;673497621;306709863;366787758
15/08/2001;11;RO;5768760;673240;5095520
15/08/2001;14;RR;413588;463858;-50270
15/08/2001;42;SC;269151010;83338445;185812565
15/08/2001;35;SP;1958981633;2303572376;-344590743
15/08/2001;28;SE;1335414;10427027;-9091613
15/08/2001;17;TO;154012;1062578;-908566
15/09/2001;12;AC;457684;50;457634
15/09/2001;27;AL;1307899;2880484;-1572585
15/09/2001;16;AP;1961450;1366874;594576
15/09/2001;13;AM;65728188;197652958;-131924770
15/09/2001;29;BA;148014055;176255834;-28241779
15/09/2001;23;CE;38782578;39905102;-1122524
15/09/2001;53;DF;77222;44124300;-44047078
15/09/2001;32;ES;139599407;194500452;-54901045
15/09/2001;52;GO;64907614;35495426;29412188
15/09/2001;21;MA;43671338;91142470;-47471132
15/09/2001;51;MT;131561386;15854551;115706835
15/09/2001;50;MS;37726938;26120258;11606680
15/09/2001;31;MG;487736195;211661432;276074763
15/09/2001;15;PA;176041384;20219806;155821578
15/09/2001;25;PB;7128624;4326583;2802041
15/09/2001;41;PR;431107972;413569353;17538619
15/09/2001;26;PE;18951611;85484994;-66533383
15/09/2001;22;PI;2189362;1038482;1150880
15/09/2001;33;RJ;119574118;391817992;-272243874
15/09/2001;24;RN;13482100;6037435;7444665
15/09/2001;43;RS;568899406;304700229;264199177
15/09/2001;11;RO;5181298;929859;4251439
15/09/2001;14;RR;305578;207475;98103
15/09/2001;42;SC;250293503;75183773;175109730
15/09/2001;35;SP;1805875155;1805261986;613169
15/09/2001;28;SE;1594859;5971558;-4376699
15/09/2001;17;TO;136889;757642;-620753
15/10/2001;12;AC;838073;15371;822702
15/10/2001;27;AL;31045920;4562867;26483053
15/10/2001;16;AP;2543654;258630;2285024
15/10/2001;13;AM;83145139;256851700;-173706561
15/10/2001;29;BA;188064330;156263657;31800673
15/10/2001;23;CE;45670747;40285197;5385550
15/10/2001;53;DF;2278813;55202949;-52924136
15/10/2001;32;ES;247234947;194454009;52780938
15/10/2001;52;GO;41027136;33663153;7363983
15/10/2001;21;MA;29532906;66886681;-37353775
15/10/2001;51;MT;152961852;35862585;117099267
15/10/2001;50;MS;50538092;6845317;43692775
15/10/2001;31;MG;515737801;274646888;241090913
15/10/2001;15;PA;236411257;20649963;215761294
15/10/2001;25;PB;8560574;6077318;2483256
15/10/2001;41;PR;501110496;399107205;102003291
15/10/2001;26;PE;29974096;89727010;-59752914
15/10/2001;22;PI;2723295;1694320;1028975
15/10/2001;33;RJ;148889825;659848549;-510958724
15/10/2001;24;RN;19915043;6832025;13083018
15/10/2001;43;RS;494819469;304474308;190345161
15/10/2001;11;RO;7101365;4950752;2150613
15/10/2001;14;RR;317824;207218;110606
15/10/2001;42;SC;269154725;77699657;191455068
15/10/2001;35;SP;1741599209;2040087657;-298488448
15/10/2001;28;SE;834422;5698298;-4863876
15/10/2001;17;TO;142431;551514;-409083
15/11/2001;12;AC;177715;3144100;-2966385
15/11/2001;27;AL;35567699;7217378;28350321
15/11/2001;16;AP;3492578;1214500;2278078
15/11/2001;13;AM;85662785;237897640;-152234855
15/11/2001;29;BA;154930503;151889009;3041494
15/11/2001;23;CE;47324823;40944127;6380696
15/11/2001;53;DF;69273;75744691;-75675418
15/11/2001;32;ES;193781469;165047005;28734464
15/11/2001;52;GO;39159602;25955508;13204094
15/11/2001;21;MA;28672138;75289696;-46617558
15/11/2001;51;MT;92217479;17541726;74675753
15/11/2001;50;MS;35128359;39851175;-4722816
15/11/2001;31;MG;488193333;175593026;312600307
15/11/2001;15;PA;136106923;14440624;121666299
15/11/2001;25;PB;11633487;5007523;6625964
15/11/2001;41;PR;416035385;346171539;69863846
15/11/2001;26;PE;38762249;82812368;-44050119
15/11/2001;22;PI;2615916;793593;1822323
15/11/2001;33;RJ;162944162;569347623;-406403461
15/11/2001;24;RN;16381388;6187154;10194234
15/11/2001;43;RS;384790859;261642330;123148529
15/11/2001;11;RO;6132782;1323279;4809503
15/11/2001;14;RR;427247;225595;201652
15/11/2001;42;SC;244519933;70372037;174147896
15/11/2001;35;SP;1701837929;1820768456;-118930527
15/11/2001;28;SE;2851268;8100067;-5248799
15/11/2001;17;TO;109048;616842;-507794
15/12/2001;12;AC;209023;1969240;-1760217
15/12/2001;27;AL;28397445;2600658;25796787
15/12/2001;16;AP;163478;888204;-724726
15/12/2001;13;AM;54291631;148275034;-93983403
15/12/2001;29;BA;176272647;194596793;-18324146
15/12/2001;23;CE;39952879;47743458;-7790579
15/12/2001;53;DF;185014;75470517;-75285503
15/12/2001;32;ES;190075152;135619894;54455258
15/12/2001;52;GO;31633634;28712588;2921046
15/12/2001;21;MA;39339868;86016285;-46676417
15/12/2001;51;MT;77476518;13417713;64058805
15/12/2001;50;MS;28376190;19065609;9310581
15/12/2001;31;MG;413568611;173505639;240062972
15/12/2001;15;PA;185944240;21533556;164410684
15/12/2001;25;PB;9685052;7354018;2331034
15/12/2001;41;PR;365349270;251227505;114121765
15/12/2001;26;PE;44187578;52185658;-7998080
15/12/2001;22;PI;4152149;697740;3454409
15/12/2001;33;RJ;231249016;405080283;-173831267
15/12/2001;24;RN;21002913;10006964;10995949
15/12/2001;43;RS;468741637;242465972;226275665
15/12/2001;11;RO;4933070;27303632;-22370562
15/12/2001;14;RR;324563;162339;162224
15/12/2001;42;SC;246987342;59370930;187616412
15/12/2001;35;SP;1577374655;1483883016;93491639
15/12/2001;28;SE;1128515;10091986;-8963471
15/12/2001;17;TO;158490;317240;-158750
15/01/2002;12;AC;25374;27690;-2316
15/01/2002;27;AL;39391909;17411878;21980031
15/01/2002;16;AP;4032242;776223;3256019
15/01/2002;13;AM;47628659;223202376;-175573717
15/01/2002;29;BA;163602320;130782174;32820146
15/01/2002;23;CE;40993026;30880565;10112461
15/01/2002;53;DF;17537;58389616;-58372079
15/01/2002;32;ES;173536468;144449433;29087035
15/01/2002;52;GO;33956773;25064930;8891843
15/01/2002;21;MA;45395492;57490801;-12095309
15/01/2002;51;MT;72116631;12797609;59319022
15/01/2002;50;MS;24084640;52783998;-28699358
15/01/2002;31;MG;452344805;318058092;134286713
15/01/2002;15;PA;170834279;26920404;143913875
15/01/2002;25;PB;11248116;5103844;6144272
15/01/2002;41;PR;250683935;240147421;10536514
15/01/2002;26;PE;29356681;76662950;-47306269
15/01/2002;22;PI;2659023;698328;1960695
15/01/2002;33;RJ;157376568;470714469;-313337901
15/01/2002;24;RN;16205694;5076779;11128915
15/01/2002;43;RS;370572968;206257567;164315401
15/01/2002;11;RO;4017235;1289772;2727463
15/01/2002;14;RR;439343;946454;-507111
15/01/2002;42;SC;197340547;86574719;110765828
15/01/2002;35;SP;1261998897;1588584650;-326585753
15/01/2002;28;SE;647250;10463924;-9816674
15/01/2002;17;TO;29946;794484;-764538
15/02/2002;12;AC;43407;1445702;-1402295
15/02/2002;27;AL;39047489;4641076;34406413
15/02/2002;16;AP;41831;85446;-43615
15/02/2002;13;AM;71797317;170927961;-99130644
15/02/2002;29;BA;105147502;163607336;-58459834
15/02/2002;23;CE;39339991;59913092;-20573101
15/02/2002;53;DF;91390;26012508;-25921118
15/02/2002;32;ES;167810873;131449296;36361577
15/02/2002;52;GO;29169905;24059570;5110335
15/02/2002;21;MA;40855422;21837890;19017532
15/02/2002;51;MT;48688155;7965267;40722888
15/02/2002;50;MS;17274042;39879843;-22605801
15/02/2002;31;MG;399783986;200040755;199743231
15/02/2002;15;PA;146866206;21185471;125680735
15/02/2002;25;PB;10888840;5720045;5168795
15/02/2002;41;PR;309097919;251823313;57274606
15/02/2002;26;PE;30824439;80280534;-49456095
15/02/2002;22;PI;1904085;594402;1309683
15/02/2002;33;RJ;142079978;404367244;-262287266
15/02/2002;24;RN;16314014;9482575;6831439
15/02/2002;43;RS;372918007;188778685;184139322
15/02/2002;11;RO;4857114;1878825;2978289
15/02/2002;14;RR;443867;93965;349902
15/02/2002;42;SC;251224916;62808875;188416041
15/02/2002;35;SP;1343627605;1507667344;-164039739
15/02/2002;28;SE;4478642;4016184;462458
15/02/2002;17;TO;42765;472322;-429557
15/03/2002;12;AC;44191;1019663;-975472
15/03/2002;27;AL;24586792;6718311;17868481
15/03/2002;16;AP;2642209;1356279;1285930
15/03/2002;13;AM;101690190;229115095;-127424905
15/03/2002;29;BA;181680526;146670291;35010235
15/03/2002;23;CE;43139450;55660661;-12521211
15/03/2002;53;DF;149714;62978129;-62828415
15/03/2002;32;ES;172471741;161390984;11080757
15/03/2002;52;GO;40527484;29449369;11078115
15/03/2002;21;MA;37311583;28434633;8876950
15/03/2002;51;MT;108854449;8289105;100565344
15/03/2002;50;MS;30244324;27186245;3058079
15/03/2002;31;MG;486248944;177400513;308848431
15/03/2002;15;PA;148297916;15819462;132478454
15/03/2002;25;PB;9824293;2385369;7438924
15/03/2002;41;PR;332115519;266284788;65830731
15/03/2002;26;PE;22797594;77561652;-54764058
15/03/2002;22;PI;2796612;855818;1940794
15/03/2002;33;RJ;270934282;392205218;-121270936
15/03/2002;24;RN;14094607;4315588;9779019
15/03/2002;43;RS;401343882;232274772;169069110
15/03/2002;11;RO;4957024;636194;4320830
15/03/2002;14;RR;607973;195088;412885
15/03/2002;42;SC;275332805;65078592;210254213
15/03/2002;35;SP;1440677108;1654294974;-213617866
15/03/2002;28;SE;730959;6592179;-5861220
15/03/2002;17;TO;226800;831302;-604502
15/04/2002;12;AC;106805;492586;-385781
15/04/2002;27;AL;24756485;4700812;20055673
15/04/2002;16;AP;162665;1240086;-1077421
15/04/2002;13;AM;88088588;286116512;-198027924
15/04/2002;29;BA;158806219;129256625;29549594
15/04/2002;23;CE;38760044;40527314;-1767270
15/04/2002;53;DF;127972;48844550;-48716578
15/04/2002;32;ES;182809627;153789299;29020328
15/04/2002;52;GO;57351891;26587857;30764034
15/04/2002;21;MA;40211757;84806987;-44595230
15/04/2002;51;MT;190849061;10580210;180268851
15/04/2002;50;MS;25907413;71818229;-45910816
15/04/2002;31;MG;482051621;215695442;266356179
15/04/2002;15;PA;201513906;21757849;179756057
15/04/2002;25;PB;8768368;9891763;-1123395
15/04/2002;41;PR;372850184;339058729;33791455
15/04/2002;26;PE;17639848;63630090;-45990242
15/04/2002;22;PI;3425111;1508515;1916596
15/04/2002;33;RJ;261915388;495102559;-233187171
15/04/2002;24;RN;14747660;37035643;-22287983
15/04/2002;43;RS;455647664;223341384;232306280
15/04/2002;11;RO;4577031;21899553;-17322522
15/04/2002;14;RR;498599;55798;442801
15/04/2002;42;SC;254078640;82310232;171768408
15/04/2002;35;SP;1609882644;1752532504;-142649860
15/04/2002;28;SE;1452319;6743291;-5290972
15/04/2002;17;TO;4235235;619443;3615792
15/05/2002;12;AC;106035;25002;81033
15/05/2002;27;AL;13906218;4905343;9000875
15/05/2002;16;AP;1506386;201007;1305379
15/05/2002;13;AM;90398372;276614740;-186216368
15/05/2002;29;BA;158576465;178425804;-19849339
15/05/2002;23;CE;44415325;100891671;-56476346
15/05/2002;53;DF;98388;54355006;-54256618
15/05/2002;32;ES;123743480;188012460;-64268980
15/05/2002;52;GO;44180678;27897833;16282845
15/05/2002;21;MA;53567231;41783137;11784094
15/05/2002;51;MT;136628308;20325600;116302708
15/05/2002;50;MS;31600247;22692211;8908036
15/05/2002;31;MG;387939956;160208622;227731334
15/05/2002;15;PA;201497456;31218987;170278469
15/05/2002;25;PB;12795344;8766042;4029302
15/05/2002;41;PR;364796787;318181768;46615019
15/05/2002;26;PE;20855806;69946613;-49090807
15/05/2002;22;PI;2640462;883841;1756621
15/05/2002;33;RJ;317331782;542507696;-225175914
15/05/2002;24;RN;16340701;8115055;8225646
15/05/2002;43;RS;561443969;221905090;339538879
15/05/2002;11;RO;3584732;2643368;941364
15/05/2002;14;RR;685054;169825;515229
15/05/2002;42;SC;255387941;76622964;178764977
15/05/2002;35;SP;1486520959;1666198511;-179677552
15/05/2002;28;SE;4235040;32397707;-28162667
15/05/2002;17;TO;92506;988504;-895998
15/06/2002;12;AC;191036;29970;161066
15/06/2002;27;AL;9954959;63851075;-53896116
15/06/2002;16;AP;2655732;289303;2366429
15/06/2002;13;AM;78797126;245831768;-167034642
15/06/2002;29;BA;143836925;132311886;11525039
15/06/2002;23;CE;42064649;33209568;8855081
15/06/2002;53;DF;26005;47172017;-47146012
15/06/2002;32;ES;14322836;118573778;-104250942
15/06/2002;52;GO;33196616;27240590;5956026
15/06/2002;21;MA;64626090;79709518;-15083428
15/06/2002;51;MT;107231864;22965189;84266675
15/06/2002;50;MS;33055891;28375176;4680715
15/06/2002;31;MG;239471804;149551567;89920237
15/06/2002;15;PA;134255593;16840875;117414718
15/06/2002;25;PB;8738388;4626034;4112354
15/06/2002;41;PR;343230991;232304877;110926114
15/06/2002;26;PE;15118351;47511265;-32392914
15/06/2002;22;PI;2967388;814392;2152996
15/06/2002;33;RJ;175248382;327138152;-151889770
15/06/2002;24;RN;25286568;6104956;19181612
15/06/2002;43;RS;568494760;192529839;375964921
15/06/2002;11;RO;5787397;3140591;2646806
15/06/2002;14;RR;431164;157534;273630
15/06/2002;42;SC;237303459;68356867;168946592
15/06/2002;35;SP;1669543269;1537140890;132402379
15/06/2002;28;SE;2314847;6223722;-3908875
15/06/2002;17;TO;2674339;524920;2149419
15/07/2002;12;AC;173707;181026;-7319
15/07/2002;27;AL;10565353;2814754;7750599
15/07/2002;16;AP;84836;526160;-441324
15/07/2002;13;AM;106003925;298149639;-192145714
15/07/2002;29;BA;277397563;226460107;50937456
15/07/2002;23;CE;44913344;41303282;3610062
15/07/2002;53;DF;3722289;44559976;-40837687
15/07/2002;32;ES;391463132;240605230;150857902
15/07/2002;52;GO;79691157;37006875;42684282
15/07/2002;21;MA;77066553;108663463;-31596910
15/07/2002;51;MT;171677221;24577068;147100153
15/07/2002;50;MS;33105216;47887044;-14781828
15/07/2002;31;MG;704413831;304020992;400392839
15/07/2002;15;PA;246335339;16741650;229593689
15/07/2002;25;PB;7954841;14245104;-6290263
15/07/2002;41;PR;487172638;288514314;198658324
15/07/2002;26;PE;17425979;133319013;-115893034
15/07/2002;22;PI;7456542;2166002;5290540
15/07/2002;33;RJ;498904162;781017286;-282113124
15/07/2002;24;RN;13366185;9233090;4133095
15/07/2002;43;RS;826674786;269673347;557001439
15/07/2002;11;RO;6042714;2383761;3658953
15/07/2002;14;RR;606440;26558;579882
15/07/2002;42;SC;282028062;90528215;191499847
15/07/2002;35;SP;1822922619;2016969533;-194046914
15/07/2002;28;SE;5962802;5286782;676020
15/07/2002;17;TO;5101116;5113790;-12674
15/08/2002;12;AC;468935;188088;280847
15/08/2002;27;AL;12447079;8310786;4136293
15/08/2002;16;AP;2663285;867791;1795494
15/08/2002;13;AM;101430370;283972083;-182541713
15/08/2002;29;BA;211249061;160926862;50322199
15/08/2002;23;CE;48729655;40783146;7946509
15/08/2002;53;DF;2803920;75738861;-72934941
15/08/2002;32;ES;298468733;180503218;117965515
15/08/2002;52;GO;69156600;26375082;42781518
15/08/2002;21;MA;74216309;89583057;-15366748
15/08/2002;51;MT;154674276;31549494;123124782
15/08/2002;50;MS;37519741;4836310;32683431
15/08/2002;31;MG;705009601;224882972;480126629
15/08/2002;15;PA;211962809;23021970;188940839
15/08/2002;25;PB;8372209;6014531;2357678
15/08/2002;41;PR;449538332;269390358;180147974
15/08/2002;26;PE;24057269;53020407;-28963138
15/08/2002;22;PI;4573728;552833;4020895
15/08/2002;33;RJ;344102580;719254588;-375152008
15/08/2002;24;RN;13376236;4505757;8870479
15/08/2002;43;RS;631208703;221940122;409268581
15/08/2002;11;RO;7708391;963987;6744404
15/08/2002;14;RR;441843;98964;342879
15/08/2002;42;SC;275257193;90308769;184948424
15/08/2002;35;SP;1923813341;1634653618;289159723
15/08/2002;28;SE;7817420;5553550;2263870
15/08/2002;17;TO;178108;5541724;-5363616
15/09/2002;12;AC;343627;111070;232557
15/09/2002;27;AL;4059240;3258411;800829
15/09/2002;16;AP;42926;1883451;-1840525
15/09/2002;13;AM;90991125;295765873;-204774748
15/09/2002;29;BA;274405980;147858622;126547358
15/09/2002;23;CE;43362964;57801966;-14439002
15/09/2002;53;DF;3740960;33626987;-29886027
15/09/2002;32;ES;192896072;154330969;38565103
15/09/2002;52;GO;78530579;29421625;49108954
15/09/2002;21;MA;56147769;75921858;-19774089
15/09/2002;51;MT;252577029;26865656;225711373
15/09/2002;50;MS;47928758;37583196;10345562
15/09/2002;31;MG;635847895;189747030;446100865
15/09/2002;15;PA;231800241;18821974;212978267
15/09/2002;25;PB;7281693;6646015;635678
15/09/2002;41;PR;1293408101;272893980;1020514121
15/09/2002;26;PE;19546078;49184724;-29638646
15/09/2002;22;PI;5754294;980882;4773412
15/09/2002;33;RJ;368704809;696762935;-328058126
15/09/2002;24;RN;28971262;9944166;19027096
15/09/2002;43;RS;561027560;235914926;325112634
15/09/2002;11;RO;7856043;1946373;5909670
15/09/2002;14;RR;404236;231060;173176
15/09/2002;42;SC;299049388;76082157;222967231
15/09/2002;35;SP;1847881533;1559332873;288548660
15/09/2002;28;SE;1194302;3237117;-2042815
15/09/2002;17;TO;2673507;6845154;-4171647
15/10/2002;12;AC;637479;31174;606305
15/10/2002;27;AL;45580026;2779731;42800295
15/10/2002;16;AP;1437704;362257;1075447
15/10/2002;13;AM;109375515;295623827;-186248312
15/10/2002;29;BA;252111573;147539238;104572335
15/10/2002;23;CE;51435503;64239932;-12804429
15/10/2002;53;DF;5992496;56819034;-50826538
15/10/2002;32;ES;323472696;153980274;169492422
15/10/2002;52;GO;73993801;24867203;49126598
15/10/2002;21;MA;58131502;148077504;-89946002
15/10/2002;51;MT;260321047;24280383;236040664
15/10/2002;50;MS;47795946;25467705;22328241
15/10/2002;31;MG;700296316;215398811;484897505
15/10/2002;15;PA;195284758;20842095;174442663
15/10/2002;25;PB;6632897;8475466;-1842569
15/10/2002;41;PR;626649548;331929908;294719640
15/10/2002;26;PE;35418895;53818487;-18399592
15/10/2002;22;PI;5768666;1128501;4640165
15/10/2002;33;RJ;463668334;415353594;48314740
15/10/2002;24;RN;20015973;8522910;11493063
15/10/2002;43;RS;641600755;266217830;375382925
15/10/2002;11;RO;8119610;1395673;6723937
15/10/2002;14;RR;513866;120178;393688
15/10/2002;42;SC;302063546;94668612;207394934
15/10/2002;35;SP;2068800955;1905523427;163277528
15/10/2002;28;SE;1147991;7068964;-5920973
15/10/2002;17;TO;594799;1150493;-555694
15/11/2002;12;AC;949627;35426;914201
15/11/2002;27;AL;40232956;1077688;39155268
15/11/2002;16;AP;1004614;110882;893732
15/11/2002;13;AM;102950781;305658035;-202707254
15/11/2002;29;BA;236165201;153486848;82678353
15/11/2002;23;CE;52877076;35330352;17546724
15/11/2002;53;DF;4690197;42808710;-38118513
15/11/2002;32;ES;268304832;133232869;135071963
15/11/2002;52;GO;59580612;24737207;34843405
15/11/2002;21;MA;54114180;58483106;-4368926
15/11/2002;51;MT;138010953;18374507;119636446
15/11/2002;50;MS;24817344;36501924;-11684580
15/11/2002;31;MG;578801323;188211008;390590315
15/11/2002;15;PA;203607199;16024125;187583074
15/11/2002;25;PB;12886237;2187055;10699182
15/11/2002;41;PR;500758184;257927557;242830627
15/11/2002;26;PE;53706387;45810459;7895928
15/11/2002;22;PI;4255589;1085029;3170560
15/11/2002;33;RJ;295075425;435180486;-140105061
15/11/2002;24;RN;20607614;4691394;15916220
15/11/2002;43;RS;485512577;345301109;140211468
15/11/2002;11;RO;9042483;52671792;-43629309
15/11/2002;14;RR;542442;30590;511852
15/11/2002;42;SC;257215565;73561638;183653927
15/11/2002;35;SP;1607852028;1601915244;5936784
15/11/2002;28;SE;5070131;5100555;-30424
15/11/2002;17;TO;102693;1999388;-1896695
15/12/2002;12;AC;727939;48346;679593
15/12/2002;27;AL;34117225;3763981;30353244
15/12/2002;16;AP;92230;524954;-432724
15/12/2002;13;AM;74151645;170127807;-95976162
15/12/2002;29;BA;242669126;152582830;90086296
15/12/2002;23;CE;52902528;41176254;11726274
15/12/2002;53;DF;5694699;33344700;-27650001
15/12/2002;32;ES;227001600;143707920;83293680
15/12/2002;52;GO;49353868;22545931;26807937
15/12/2002;21;MA;50723596;73209328;-22485732
15/12/2002;51;MT;153342692;6432014;146910678
15/12/2002;50;MS;30723393;26884543;3838850
15/12/2002;31;MG;566108026;166889481;399218545
15/12/2002;15;PA;173841141;23690489;150150652
15/12/2002;25;PB;12232836;4566372;7666464
15/12/2002;41;PR;357061026;270489920;86571106
15/12/2002;26;PE;33021007;52591726;-19570719
15/12/2002;22;PI;3861438;1387152;2474286
15/12/2002;33;RJ;320647947;413568910;-92920963
15/12/2002;24;RN;24024880;9854776;14170104
15/12/2002;43;RS;495597755;229641513;265956242
15/12/2002;11;RO;6515821;2169023;4346798
15/12/2002;14;RR;407426;65633;341793
15/12/2002;42;SC;266532499;76565793;189966706
15/12/2002;35;SP;1949278796;1502011865;447266931
15/12/2002;28;SE;2512578;6608426;-4095848
15/12/2002;17;TO;256626;1883582;-1626956
15/01/2003;12;AC;340410;60388;280022
15/01/2003;27;AL;72392704;2160255;70232449
15/01/2003;16;AP;283225;35807;247418
15/01/2003;13;AM;59779516;229862595;-170083079
15/01/2003;29;BA;199829210;190334925;9494285
15/01/2003;23;CE;53279460;32565025;20714435
15/01/2003;53;DF;245430;61595034;-61349604
15/01/2003;32;ES;308291633;167958942;140332691
15/01/2003;52;GO;40394535;18607582;21786953
15/01/2003;21;MA;66414854;30337331;36077523
15/01/2003;51;MT;126249814;7608142;118641672
15/01/2003;50;MS;35245363;28366780;6878583
15/01/2003;31;MG;527482339;173750329;353732010
15/01/2003;15;PA;244879852;13970663;230909189
15/01/2003;25;PB;8426039;2107853;6318186
15/01/2003;41;PR;412073217;230009258;182063959
15/01/2003;26;PE;31890790;68847419;-36956629
15/01/2003;22;PI;2538454;933122;1605332
15/01/2003;33;RJ;254639166;432470734;-177831568
15/01/2003;24;RN;23499742;8464705;15035037
15/01/2003;43;RS;448812800;211048805;237763995
15/01/2003;11;RO;5232837;981178;4251659
15/01/2003;14;RR;305249;14010;291239
15/01/2003;42;SC;203091375;83349387;119741988
15/01/2003;35;SP;1589233451;1647755021;-58521570
15/01/2003;28;SE;1816188;7787979;-5971791
15/01/2003;17;TO;279967;2570309;-2290342
15/02/2003;12;AC;513887;33582;480305
15/02/2003;27;AL;43126693;3819326;39307367
15/02/2003;16;AP;1389594;49052;1340542
15/02/2003;13;AM;90657674;222722500;-132064826
15/02/2003;29;BA;300482123;186889784;113592339
15/02/2003;23;CE;51190655;32143334;19047321
15/02/2003;53;DF;1802987;20167927;-18364940
15/02/2003;32;ES;280837496;126649635;154187861
15/02/2003;52;GO;37018144;31635227;5382917
15/02/2003;21;MA;55693713;87897471;-32203758
15/02/2003;51;MT;93879904;38196005;55683899
15/02/2003;50;MS;33707413;35283119;-1575706
15/02/2003;31;MG;553611930;160719298;392892632
15/02/2003;15;PA;181021334;20410305;160611029
15/02/2003;25;PB;13097243;2416136;10681107
15/02/2003;41;PR;405451810;235759651;169692159
15/02/2003;26;PE;35762530;132656295;-96893765
15/02/2003;22;PI;3764831;842119;2922712
15/02/2003;33;RJ;382073266;511966338;-129893072
15/02/2003;24;RN;15506070;12185805;3320265
15/02/2003;43;RS;509200572;312646210;196554362
15/02/2003;11;RO;6560347;434978;6125369
15/02/2003;14;RR;558513;49048;509465
15/02/2003;42;SC;267197316;86768702;180428614
15/02/2003;35;SP;1550439852;1613289355;-62849503
15/02/2003;28;SE;1069792;9424180;-8354388
15/02/2003;17;TO;306523;944040;-637517
15/03/2003;12;AC;154786;22620;132166
15/03/2003;27;AL;23172174;3830592;19341582
15/03/2003;16;AP;154457;79883;74574
15/03/2003;13;AM;86305205;288392871;-202087666
15/03/2003;29;BA;223508882;138205577;85303305
15/03/2003;23;CE;49395647;39501405;9894242
15/03/2003;53;DF;373509;36927637;-36554128
15/03/2003;32;ES;295846243;160495085;135351158
15/03/2003;52;GO;49584184;28276531;21307653
15/03/2003;21;MA;15739013;51025680;-35286667
15/03/2003;51;MT;154876775;23630727;131246048
15/03/2003;50;MS;34247105;31504329;2742776
15/03/2003;31;MG;554061022;179784518;374276504
15/03/2003;15;PA;191990098;15051912;176938186
15/03/2003;25;PB;11622316;4678213;6944103
15/03/2003;41;PR;527623674;268524579;259099095
15/03/2003;26;PE;33751182;42969488;-9218306
15/03/2003;22;PI;4263902;1140153;3123749
15/03/2003;33;RJ;467048730;394094194;72954536
15/03/2003;24;RN;19780585;11226410;8554175
15/03/2003;43;RS;475941749;246144037;229797712
15/03/2003;11;RO;7467796;606672;6861124
15/03/2003;14;RR;177770;34737;143033
15/03/2003;42;SC;279258440;66606966;212651474
15/03/2003;35;SP;1597480445;1657920798;-60440353
15/03/2003;28;SE;957531;10110287;-9152756
15/03/2003;17;TO;251401;1209436;-958035
15/04/2003;12;AC;248633;27375;221258
15/04/2003;27;AL;15155839;8198402;6957437
15/04/2003;16;AP;1534227;1178639;355588
15/04/2003;13;AM;113822595;305948591;-192125996
15/04/2003;29;BA;274477200;135211274;139265926
15/04/2003;23;CE;58799821;50325511;8474310
15/04/2003;53;DF;263888;51151108;-50887220
15/04/2003;32;ES;229951023;146152009;83799014
15/04/2003;52;GO;69938290;23804529;46133761
15/04/2003;21;MA;74053192;70231634;3821558
15/04/2003;51;MT;220393221;11612568;208780653
15/04/2003;50;MS;37751917;33053674;4698243
15/04/2003;31;MG;525066687;222485619;302581068
15/04/2003;15;PA;192884842;26959012;165925830
15/04/2003;25;PB;13803789;6069800;7733989
15/04/2003;41;PR;656311726;290575605;365736121
15/04/2003;26;PE;25558358;59420690;-33862332
15/04/2003;22;PI;4709753;680641;4029112
15/04/2003;33;RJ;325242965;467810138;-142567173
15/04/2003;24;RN;19799696;5261320;14538376
15/04/2003;43;RS;638249341;288931443;349317898
15/04/2003;11;RO;6663988;1994687;4669301
15/04/2003;14;RR;440090;98400;341690
15/04/2003;42;SC;296044728;82205672;213839056
15/04/2003;35;SP;1745535050;1695134101;50400949
15/04/2003;28;SE;6627330;7463904;-836574
15/04/2003;17;TO;2669107;2290512;378595
15/05/2003;12;AC;551134;197644;353490
15/05/2003;27;AL;30508243;3590120;26918123
15/05/2003;16;AP;3611101;224374;3386727
15/05/2003;13;AM;109974510;292436353;-182461843
15/05/2003;29;BA;302775880;132076648;170699232
15/05/2003;23;CE;69071399;42638516;26432883
15/05/2003;53;DF;1123372;58950399;-57827027
15/05/2003;32;ES;298950867;166947303;132003564
15/05/2003;52;GO;113000305;29040260;83960045
15/05/2003;21;MA;72487286;57190600;15296686
15/05/2003;51;MT;224450887;14426553;210024334
15/05/2003;50;MS;40511738;40446758;64980
15/05/2003;31;MG;673405743;188116302;485289441
15/05/2003;15;PA;231861156;23906894;207954262
15/05/2003;25;PB;12845157;8903655;3941502
15/05/2003;41;PR;713688314;269701314;443987000
15/05/2003;26;PE;28914723;66094820;-37180097
15/05/2003;22;PI;4693902;897595;3796307
15/05/2003;33;RJ;332677526;427433816;-94756290
15/05/2003;24;RN;17175252;8669022;8506230
15/05/2003;43;RS;784701681;283333033;501368648
15/05/2003;11;RO;7119551;1655212;5464339
15/05/2003;14;RR;210173;220642;-10469
15/05/2003;42;SC;302039112;74823063;227216049
15/05/2003;35;SP;1825944137;1658873815;167070322
15/05/2003;28;SE;989333;7432779;-6443446
15/05/2003;17;TO;11099748;469654;10630094
15/06/2003;12;AC;568827;88938;479889
15/06/2003;27;AL;13976677;2967209;11009468
15/06/2003;16;AP;734168;435360;298808
15/06/2003;13;AM;113824019;243675710;-129851691
15/06/2003;29;BA;247449493;118211525;129237968
15/06/2003;23;CE;60018482;42649660;17368822
15/06/2003;53;DF;1165860;32388341;-31222481
15/06/2003;32;ES;212649691;141760973;70888718
15/06/2003;52;GO;163505491;25112230;138393261
15/06/2003;21;MA;56428389;54327169;2101220
15/06/2003;51;MT;168608761;12965423;155643338
15/06/2003;50;MS;42713032;40880287;1832745
15/06/2003;31;MG;571154352;186195066;384959286
15/06/2003;15;PA;185973232;29161633;156811599
15/06/2003;25;PB;9705788;7777564;1928224
15/06/2003;41;PR;627632123;286828567;340803556
15/06/2003;26;PE;31518892;41323903;-9805011
15/06/2003;22;PI;3758599;853740;2904859
15/06/2003;33;RJ;345142643;395836240;-50693597
15/06/2003;24;RN;15512391;10944615;4567776
15/06/2003;43;RS;761468612;247495373;513973239
15/06/2003;11;RO;7312288;1135603;6176685
15/06/2003;14;RR;283869;56462;227407
15/06/2003;42;SC;292940906;67346868;225594038
15/06/2003;35;SP;1793789167;1517520288;276268879
15/06/2003;28;SE;1990538;6758773;-4768235
15/06/2003;17;TO;3906430;2699242;1207188
15/07/2003;12;AC;490253;46386;443867
15/07/2003;27;AL;15605565;6253855;9351710
15/07/2003;16;AP;635439;227274;408165
15/07/2003;13;AM;129236059;264377101;-135141042
15/07/2003;29;BA;244779023;142360351;102418672
15/07/2003;23;CE;62578191;27056425;35521766
15/07/2003;53;DF;456418;50530372;-50073954
15/07/2003;32;ES;369729946;172155148;197574798
15/07/2003;52;GO;69192999;22570527;46622472
15/07/2003;21;MA;65533002;19061180;46471822
15/07/2003;51;MT;151046873;22660413;128386460
15/07/2003;50;MS;45352207;43159244;2192963
15/07/2003;31;MG;561252446;211541659;349710787
15/07/2003;15;PA;198706780;33588147;165118633
15/07/2003;25;PB;15046874;4699571;10347303
15/07/2003;41;PR;562678756;338674918;224003838
15/07/2003;26;PE;28299085;47208520;-18909435
15/07/2003;22;PI;2811028;499967;2311061
15/07/2003;33;RJ;412509258;441082114;-28572856
15/07/2003;24;RN;20724511;80281088;-59556577
15/07/2003;43;RS;813756721;307701748;506054973
15/07/2003;11;RO;8925466;1304553;7620913
15/07/2003;14;RR;315392;109490;205902
15/07/2003;42;SC;295925935;70862999;225062936
15/07/2003;35;SP;1912027272;1722360304;189666968
15/07/2003;28;SE;7095106;5546531;1548575
15/07/2003;17;TO;2235300;1215727;1019573
15/08/2003;12;AC;259793;51088;208705
15/08/2003;27;AL;2999182;1800961;1198221
15/08/2003;16;AP;2864908;589303;2275605
15/08/2003;13;AM;121789788;273684396;-151894608
15/08/2003;29;BA;274038755;143291850;130746905
15/08/2003;23;CE;64382793;22915499;41467294
15/08/2003;53;DF;710592;33446196;-32735604
15/08/2003;32;ES;195484369;169436541;26047828
15/08/2003;52;GO;150305808;31975629;118330179
15/08/2003;21;MA;51499651;37928583;13571068
15/08/2003;51;MT;239704782;29041636;210663146
15/08/2003;50;MS;50025067;42637652;7387415
15/08/2003;31;MG;650017816;211727958;438289858
15/08/2003;15;PA;153719493;22501289;131218204
15/08/2003;25;PB;12843954;7906534;4937420
15/08/2003;41;PR;829280795;289741056;539539739
15/08/2003;26;PE;19147926;47661137;-28513211
15/08/2003;22;PI;3638028;791988;2846040
15/08/2003;33;RJ;304444119;414746358;-110302239
15/08/2003;24;RN;16171344;3783227;12388117
15/08/2003;43;RS;625449786;249681308;375768478
15/08/2003;11;RO;9057682;1012090;8045592
15/08/2003;14;RR;661744;388223;273521
15/08/2003;42;SC;345332497;80694806;264637691
15/08/2003;35;SP;2125532815;1599626140;525906675
15/08/2003;28;SE;3100006;6984924;-3884918
15/08/2003;17;TO;8386905;2036432;6350473
15/09/2003;12;AC;404235;104635;299600
15/09/2003;27;AL;3635095;7520255;-3885160
15/09/2003;16;AP;2338588;592309;1746279
15/09/2003;13;AM;132087744;351792426;-219704682
15/09/2003;29;BA;306178431;209793617;96384814
15/09/2003;23;CE;92241119;52974129;39266990
15/09/2003;53;DF;2931398;45596779;-42665381
15/09/2003;32;ES;353841446;208611357;145230089
15/09/2003;52;GO;108532566;33361743;75170823
15/09/2003;21;MA;68606866;103651729;-35044863
15/09/2003;51;MT;255810172;32866734;222943438
15/09/2003;50;MS;48007654;45904268;2103386
15/09/2003;31;MG;744779070;253294830;491484240
15/09/2003;15;PA;289730438;25879277;263851161
15/09/2003;25;PB;16954402;3804603;13149799
15/09/2003;41;PR;664909436;321416701;343492735
15/09/2003;26;PE;30465861;51221095;-20755234
15/09/2003;22;PI;5996362;1049050;4947312
15/09/2003;33;RJ;498155817;540118914;-41963097
15/09/2003;24;RN;45222562;8590236;36632326
15/09/2003;43;RS;792743833;430986314;361757519
15/09/2003;11;RO;9393014;3091774;6301240
15/09/2003;14;RR;144668;378414;-233746
15/09/2003;42;SC;353279674;94357424;258922250
15/09/2003;35;SP;2283306077;1776917862;506388215
15/09/2003;28;SE;2409804;11028293;-8618489
15/09/2003;17;TO;1646319;1479304;167015
15/10/2003;12;AC;479853;53711;426142
15/10/2003;27;AL;28687769;2634891;26052878
15/10/2003;16;AP;1405886;327130;1078756
15/10/2003;13;AM;139499261;406194709;-266695448
15/10/2003;29;BA;347916464;159307158;188609306
15/10/2003;23;CE;68262178;36418073;31844105
15/10/2003;53;DF;3422189;76192584;-72770395
15/10/2003;32;ES;363015357;219041155;143974202
15/10/2003;52;GO;141139206;43639872;97499334
15/10/2003;21;MA;108075709;111016129;-2940420
15/10/2003;51;MT;253297996;30678362;222619634
15/10/2003;50;MS;57987000;44763566;13223434
15/10/2003;31;MG;749594995;218119012;531475983
15/10/2003;15;PA;343511488;20680387;322831101
15/10/2003;25;PB;21788277;5034647;16753630
15/10/2003;41;PR;661457982;324543170;336914812
15/10/2003;26;PE;45456051;61765000;-16308949
15/10/2003;22;PI;10298840;645441;9653399
15/10/2003;33;RJ;564235891;826384748;-262148857
15/10/2003;24;RN;43203832;10254571;32949261
15/10/2003;43;RS;848708408;344610522;504097886
15/10/2003;11;RO;10557764;1284070;9273694
15/10/2003;14;RR;311282;247765;63517
15/10/2003;42;SC;358396149;104455433;253940716
15/10/2003;35;SP;2239007032;1964355699;274651333
15/10/2003;28;SE;7297140;7634663;-337523
15/10/2003;17;TO;10205600;551906;9653694
15/11/2003;12;AC;760212;27027;733185
15/11/2003;27;AL;42380966;3904259;38476707
15/11/2003;16;AP;888115;889203;-1088
15/11/2003;13;AM;120075860;308327415;-188251555
15/11/2003;29;BA;289832158;221342735;68489423
15/11/2003;23;CE;59705883;136487185;-76781302
15/11/2003;53;DF;1441091;19374855;-17933764
15/11/2003;32;ES;251566813;193675559;57891254
15/11/2003;52;GO;68704636;38736624;29968012
15/11/2003;21;MA;60024405;25857764;34166641
15/11/2003;51;MT;92692824;32038388;60654436
15/11/2003;50;MS;36414744;55112248;-18697504
15/11/2003;31;MG;688464981;201086599;487378382
15/11/2003;15;PA;276084546;29321281;246763265
15/11/2003;25;PB;14372386;2400644;11971742
15/11/2003;41;PR;517732080;372925179;144806901
15/11/2003;26;PE;50185523;43615610;6569913
15/11/2003;22;PI;7941496;1191418;6750078
15/11/2003;33;RJ;427010529;403942607;23067922
15/11/2003;24;RN;30820835;3541959;27278876
15/11/2003;43;RS;649959815;232586242;417373573
15/11/2003;11;RO;8944842;1617954;7326888
15/11/2003;14;RR;223548;325961;-102413
15/11/2003;42;SC;338501811;96410425;242091386
15/11/2003;35;SP;1792725789;1827700059;-34974270
15/11/2003;28;SE;2554931;7891839;-5336908
15/11/2003;17;TO;3510208;1016500;2493708
15/12/2003;12;AC;565037;104344;460693
15/12/2003;27;AL;69267182;3085088;66182094
15/12/2003;16;AP;3723417;353579;3369838
15/12/2003;13;AM;82203061;227760580;-145557519
15/12/2003;29;BA;244703158;155399843;89303315
15/12/2003;23;CE;71709526;39216197;32493329
15/12/2003;53;DF;834272;52264745;-51430473
15/12/2003;32;ES;284930245;200867171;84063074
15/12/2003;52;GO;86682635;39768265;46914370
15/12/2003;21;MA;44981969;13449408;31532561
15/12/2003;51;MT;204564851;33503602;171061249
15/12/2003;50;MS;35928254;60761526;-24833272
15/12/2003;31;MG;631783232;224328712;407454520
15/12/2003;15;PA;184900142;33914322;150985820
15/12/2003;25;PB;17743290;4075148;13668142
15/12/2003;41;PR;553162917;265341795;287821122
15/12/2003;26;PE;49597785;57499330;-7901545
15/12/2003;22;PI;3882615;769977;3112638
15/12/2003;33;RJ;466537412;403293181;63244231
15/12/2003;24;RN;42728737;6011161;36717576
15/12/2003;43;RS;660365084;322267789;338097295
15/12/2003;11;RO;10352774;1129055;9223719
15/12/2003;14;RR;192940;383577;-190637
15/12/2003;42;SC;361325262;82151757;279173505
15/12/2003;35;SP;2510142821;1757329934;752812887
15/12/2003;28;SE;2905424;7000735;-4095311
15/12/2003;17;TO;1083455;3167200;-2083745
15/01/2004;12;AC;836837;38610;798227
15/01/2004;27;AL;56320408;9496736;46823672
15/01/2004;16;AP;5254643;853651;4400992
15/01/2004;13;AM;61205540;285137693;-223932153
15/01/2004;29;BA;228371539;174550121;53821418
15/01/2004;23;CE;62906848;38887761;24019087
15/01/2004;53;DF;936405;18357069;-17420664
15/01/2004;32;ES;363477351;200215988;163261363
15/01/2004;52;GO;71518546;50813213;20705333
15/01/2004;21;MA;98931544;51156514;47775030
15/01/2004;51;MT;127475169;34747958;92727211
15/01/2004;50;MS;31452567;56397978;-24945411
15/01/2004;31;MG;673758817;228990405;444768412
15/01/2004;15;PA;275875563;15782932;260092631
15/01/2004;25;PB;15369448;4825267;10544181
15/01/2004;41;PR;504833732;249836235;254997497
15/01/2004;26;PE;35685278;72178695;-36493417
15/01/2004;22;PI;9518484;600534;8917950
15/01/2004;33;RJ;399581025;422819085;-23238060
15/01/2004;24;RN;55929144;17321785;38607359
15/01/2004;43;RS;617687166;239982193;377704973
15/01/2004;11;RO;10843003;1157145;9685858
15/01/2004;14;RR;301958;244045;57913
15/01/2004;42;SC;273909527;96854477;177055050
15/01/2004;35;SP;1731789864;1925394414;-193604550
15/01/2004;28;SE;3613624;7163401;-3549777
15/01/2004;17;TO;1497542;3879607;-2382065
15/02/2004;12;AC;859809;20520;839289
15/02/2004;27;AL;61716702;4384832;57331870
15/02/2004;16;AP;1467518;950715;516803
15/02/2004;13;AM;59535771;220881939;-161346168
15/02/2004;29;BA;231691879;166565446;65126433
15/02/2004;23;CE;61481871;31860600;29621271
15/02/2004;53;DF;633621;34878384;-34244763
15/02/2004;32;ES;232331042;142840039;89491003
15/02/2004;52;GO;89986721;40088236;49898485
15/02/2004;21;MA;71832029;10037553;61794476
15/02/2004;51;MT;199988805;32693127;167295678
15/02/2004;50;MS;32269079;64063766;-31794687
15/02/2004;31;MG;606059766;193819235;412240531
15/02/2004;15;PA;247101403;11748157;235353246
15/02/2004;25;PB;16307196;5649280;10657916
15/02/2004;41;PR;520381051;259499391;260881660
15/02/2004;26;PE;27046044;56062067;-29016023
15/02/2004;22;PI;3904574;1227831;2676743
15/02/2004;33;RJ;390951971;418122054;-27170083
15/02/2004;24;RN;21535320;13329332;8205988
15/02/2004;43;RS;613569322;281174496;332394826
15/02/2004;11;RO;7588607;1331667;6256940
15/02/2004;14;RR;401098;307392;93706
15/02/2004;42;SC;321326121;86411289;234914832
15/02/2004;35;SP;1794798366;1659596682;135201684
15/02/2004;28;SE;4617348;7602021;-2984673
15/02/2004;17;TO;649555;3521713;-2872158
15/03/2004;12;AC;1117036;32967;1084069
15/03/2004;27;AL;37500153;3003452;34496701
15/03/2004;16;AP;2365339;2092000;273339
15/03/2004;13;AM;79070562;356043990;-276973428
15/03/2004;29;BA;272771002;230147243;42623759
15/03/2004;23;CE;72726577;43869602;28856975
15/03/2004;53;DF;1775805;53282285;-51506480
15/03/2004;32;ES;333118388;263842671;69275717
15/03/2004;52;GO;94992525;37458170;57534355
15/03/2004;21;MA;99336116;22669609;76666507
15/03/2004;51;MT;297872233;27572578;270299655
15/03/2004;50;MS;68684942;64313856;4371086
15/03/2004;31;MG;834411907;256989796;577422111
15/03/2004;15;PA;325212725;39637554;285575171
15/03/2004;25;PB;16845732;10959617;5886115
15/03/2004;41;PR;797918588;307450195;490468393
15/03/2004;26;PE;39089627;66792314;-27702687
15/03/2004;22;PI;5492798;1897424;3595374
15/03/2004;33;RJ;490969165;620158102;-129188937
15/03/2004;24;RN;34810783;10253187;24557596
15/03/2004;43;RS;844038017;340432767;503605250
15/03/2004;11;RO;9876146;2122394;7753752
15/03/2004;14;RR;389955;308847;81108
15/03/2004;42;SC;392866503;114867691;277998812
15/03/2004;35;SP;2543382097;2446456523;96925574
15/03/2004;28;SE;2313240;10346466;-8033226
15/03/2004;17;TO;1199150;3923436;-2724286
15/04/2004;12;AC;877283;20250;857033
15/04/2004;27;AL;28528983;7507544;21021439
15/04/2004;16;AP;2741155;2625129;116026
15/04/2004;13;AM;75435671;305484271;-230048600
15/04/2004;29;BA;240584909;208672548;31912361
15/04/2004;23;CE;69962854;47129334;22833520
15/04/2004;53;DF;2435138;21870686;-19435548
15/04/2004;32;ES;209693939;182735367;26958572
15/04/2004;52;GO;135103019;35608121;99494898
15/04/2004;21;MA;54007923;10628061;43379862
15/04/2004;51;MT;212916027;18170570;194745457
15/04/2004;50;MS;80047541;65423160;14624381
15/04/2004;31;MG;660669013;211448448;449220565
15/04/2004;15;PA;165157115;12117145;153039970
15/04/2004;25;PB;16662650;10431823;6230827
15/04/2004;41;PR;584451213;258001562;326449651
15/04/2004;26;PE;31216506;42855129;-11638623
15/04/2004;22;PI;4551901;1047297;3504604
15/04/2004;33;RJ;351299895;559028737;-207728842
15/04/2004;24;RN;21281840;12288665;8993175
15/04/2004;43;RS;737528190;309018828;428509362
15/04/2004;11;RO;8571293;2076438;6494855
15/04/2004;14;RR;324665;218088;106577
15/04/2004;42;SC;341359730;128251950;213107780
15/04/2004;35;SP;2356503726;2160029887;196473839
15/04/2004;28;SE;4068865;8876040;-4807175
15/04/2004;17;TO;1295209;6017151;-4721942
15/05/2004;12;AC;555028;20093;534935
15/05/2004;27;AL;12043386;9969947;2073439
15/05/2004;16;AP;1502775;272819;1229956
15/05/2004;13;AM;96863854;287964259;-191100405
15/05/2004;29;BA;254282119;196104729;58177390
15/05/2004;23;CE;70784776;32222563;38562213
15/05/2004;53;DF;2409653;71733446;-69323793
15/05/2004;32;ES;370087229;204536257;165550972
15/05/2004;52;GO;116860359;34769530;82090829
15/05/2004;21;MA;41818442;21399432;20419010
15/05/2004;51;MT;321620246;32707816;288912430
15/05/2004;50;MS;51960182;56780831;-4820649
15/05/2004;31;MG;782226139;189560283;592665856
15/05/2004;15;PA;203341915;37936266;165405649
15/05/2004;25;PB;13813271;12922859;890412
15/05/2004;41;PR;830913488;290508107;540405381
15/05/2004;26;PE;28894173;48143377;-19249204
15/05/2004;22;PI;5633546;622483;5011063
15/05/2004;33;RJ;546755919;711054607;-164298688
15/05/2004;24;RN;63528492;10656055;52872437
15/05/2004;43;RS;834672136;304673096;529999040
15/05/2004;11;RO;8958334;1364396;7593938
15/05/2004;14;RR;716311;351985;364326
15/05/2004;42;SC;397354563;94032224;303322339
15/05/2004;35;SP;2667905410;2170062068;497843342
15/05/2004;28;SE;1820900;8473247;-6652347
15/05/2004;17;TO;1176141;1382585;-206444
15/06/2004;12;AC;465754;64669;401085
15/06/2004;27;AL;28188445;2963226;25225219
15/06/2004;16;AP;10974933;3878073;7096860
15/06/2004;13;AM;88112313;360703051;-272590738
15/06/2004;29;BA;438818044;205933103;232884941
15/06/2004;23;CE;74063602;36653024;37410578
15/06/2004;53;DF;3543112;28816516;-25273404
15/06/2004;32;ES;373830126;234709117;139121009
15/06/2004;52;GO;160130448;54775386;105355062
15/06/2004;21;MA;76801876;38457452;38344424
15/06/2004;51;MT;292728868;38072706;254656162
15/06/2004;50;MS;70553400;65136243;5417157
15/06/2004;31;MG;912407335;284359177;628048158
15/06/2004;15;PA;236799204;39341663;197457541
15/06/2004;25;PB;13653213;9994548;3658665
15/06/2004;41;PR;1483085975;458793373;1024292602
15/06/2004;26;PE;41136140;57697829;-16561689
15/06/2004;22;PI;4932809;2023364;2909445
15/06/2004;33;RJ;542371955;695251292;-152879337
15/06/2004;24;RN;60656170;11132999;49523171
15/06/2004;43;RS;893913230;298464699;595448531
15/06/2004;11;RO;11834532;2325683;9508849
15/06/2004;14;RR;530834;197299;333535
15/06/2004;42;SC;441119364;121146322;319973042
15/06/2004;35;SP;2842770486;2461570061;381200425
15/06/2004;28;SE;3400155;9086574;-5686419
15/06/2004;17;TO;32040417;1604884;30435533
15/07/2004;12;AC;402298;143459;258839
15/07/2004;27;AL;43218284;4896731;38321553
15/07/2004;16;AP;2636924;5236687;-2599763
15/07/2004;13;AM;95828620;411281133;-315452513
15/07/2004;29;BA;443483944;311451291;132032653
15/07/2004;23;CE;71740730;38475178;33265552
15/07/2004;53;DF;3014206;42275046;-39260840
15/07/2004;32;ES;346236553;270529866;75706687
15/07/2004;52;GO;144767611;57992453;86775158
15/07/2004;21;MA;189535178;42065937;147469241
15/07/2004;51;MT;305089302;46957646;258131656
15/07/2004;50;MS;53110529;65628122;-12517593
15/07/2004;31;MG;860733805;287339043;573394762
15/07/2004;15;PA;444264454;18305589;425958865
15/07/2004;25;PB;21504481;5515409;15989072
15/07/2004;41;PR;880939434;376163098;504776336
15/07/2004;26;PE;50493455;66066084;-15572629
15/07/2004;22;PI;5481362;1073979;4407383
15/07/2004;33;RJ;491357863;621277102;-129919239
15/07/2004;24;RN;82902102;13714262;69187840
15/07/2004;43;RS;930020502;361414563;568605939
15/07/2004;11;RO;11249968;2390806;8859162
15/07/2004;14;RR;432657;56339;376318
15/07/2004;42;SC;438903473;99881660;339021813
15/07/2004;35;SP;2870485959;2357955457;512530502
15/07/2004;28;SE;4838495;11082622;-6244127
15/07/2004;17;TO;54362637;3338987;51023650
15/08/2004;12;AC;408334;19605;388729
15/08/2004;27;AL;14451552;1451526;13000026
15/08/2004;16;AP;5697230;7259957;-1562727
15/08/2004;13;AM;97614567;451946704;-354332137
15/08/2004;29;BA;375839422;236805938;139033484
15/08/2004;23;CE;70392396;39764026;30628370
15/08/2004;53;DF;2216557;40654293;-38437736
15/08/2004;32;ES;316464454;248149393;68315061
15/08/2004;52;GO;134312522;49304062;85008460
15/08/2004;21;MA;129892458;69797138;60095320
15/08/2004;51;MT;310883389;35768200;275115189
15/08/2004;50;MS;51039030;19429679;31609351
15/08/2004;31;MG;880185804;279790066;600395738
15/08/2004;15;PA;425648154;21475190;404172964
15/08/2004;25;PB;14101179;6824750;7276429
15/08/2004;41;PR;932226993;387154308;545072685
15/08/2004;26;PE;25894555;77456683;-51562128
15/08/2004;22;PI;7945813;1244063;6701750
15/08/2004;33;RJ;673109106;745899240;-72790134
15/08/2004;24;RN;61195830;10048903;51146927
15/08/2004;43;RS;958154177;379273012;578881165
15/08/2004;11;RO;12753140;1903912;10849228
15/08/2004;14;RR;456048;16825;439223
15/08/2004;42;SC;487894487;151054651;336839836
15/08/2004;35;SP;2881284057;2346938705;534345352
15/08/2004;28;SE;6407358;6001531;405827
15/08/2004;17;TO;12774680;2109279;10665401
15/09/2004;12;AC;535108;87400;447708
15/09/2004;27;AL;11110023;7925786;3184237
15/09/2004;16;AP;6164099;3735864;2428235
15/09/2004;13;AM;101515420;452324891;-350809471
15/09/2004;29;BA;358538637;315363305;43175332
15/09/2004;23;CE;72920886;35210120;37710766
15/09/2004;53;DF;3620427;63887397;-60266970
15/09/2004;32;ES;408430163;255959509;152470654
15/09/2004;52;GO;174202502;65128576;109073926
15/09/2004;21;MA;170766179;27337946;143428233
15/09/2004;51;MT;309005257;34717663;274287594
15/09/2004;50;MS;55798697;121800995;-66002298
15/09/2004;31;MG;1014981292;246509574;768471718
15/09/2004;15;PA;376404802;23782558;352622244
15/09/2004;25;PB;21693779;10821398;10872381
15/09/2004;41;PR;843563332;359254486;484308846
15/09/2004;26;PE;34484176;79627368;-45143192
15/09/2004;22;PI;4175438;1941863;2233575
15/09/2004;33;RJ;400833975;584983131;-184149156
15/09/2004;24;RN;27066136;8383479;18682657
15/09/2004;43;RS;1012597808;398611038;613986770
15/09/2004;11;RO;12561631;2485668;10075963
15/09/2004;14;RR;512315;78139;434176
15/09/2004;42;SC;437221427;137193652;300027775
15/09/2004;35;SP;2893682050;2495870961;397811089
15/09/2004;28;SE;6980198;8892397;-1912199
15/09/2004;17;TO;4231443;2604177;1627266
15/10/2004;12;AC;344825;116041;228784
15/10/2004;27;AL;44843433;6407366;38436067
15/10/2004;16;AP;66955;433304;-366349
15/10/2004;13;AM;151420846;418494440;-267073594
15/10/2004;29;BA;395381038;257779177;137601861
15/10/2004;23;CE;73209510;81993189;-8783679
15/10/2004;53;DF;4182659;39970814;-35788155
15/10/2004;32;ES;348248603;262288008;85960595
15/10/2004;52;GO;121694001;55381574;66312427
15/10/2004;21;MA;84192776;236777183;-152584407
15/10/2004;51;MT;273871745;48891057;224980688
15/10/2004;50;MS;44045427;69541986;-25496559
15/10/2004;31;MG;901903514;248718923;653184591
15/10/2004;15;PA;339103331;13696511;325406820
15/10/2004;25;PB;16329293;5993183;10336110
15/10/2004;41;PR;715066723;368369488;346697235
15/10/2004;26;PE;44421097;59652163;-15231066
15/10/2004;22;PI;4221724;1242402;2979322
15/10/2004;33;RJ;437703875;687227781;-249523906
15/10/2004;24;RN;26420162;7983551;18436611
15/10/2004;43;RS;828602369;435431295;393171074
15/10/2004;11;RO;10175978;2147530;8028448
15/10/2004;14;RR;519159;258534;260625
15/10/2004;42;SC;431478297;147961314;283516983
15/10/2004;35;SP;2741319722;2377103449;364216273
15/10/2004;28;SE;2599672;6015236;-3415564
15/10/2004;17;TO;4154095;1361344;2792751
15/11/2004;12;AC;746907;13306;733601
15/11/2004;27;AL;45131024;6742863;38388161
15/11/2004;16;AP;5409409;399319;5010090
15/11/2004;13;AM;136465440;433822136;-297356696
15/11/2004;29;BA;397102397;349942970;47159427
15/11/2004;23;CE;72198157;101886863;-29688706
15/11/2004;53;DF;2299315;46309043;-44009728
15/11/2004;32;ES;449271335;305360668;143910667
15/11/2004;52;GO;79250021;66992585;12257436
15/11/2004;21;MA;75342257;116941308;-41599051
15/11/2004;51;MT;251740013;44957681;206782332
15/11/2004;50;MS;55989362;70557134;-14567772
15/11/2004;31;MG;906187137;311309610;594877527
15/11/2004;15;PA;402624554;16826149;385798405
15/11/2004;25;PB;24477464;6609581;17867883
15/11/2004;41;PR;639583152;312850840;326732312
15/11/2004;26;PE;60700736;60123104;577632
15/11/2004;22;PI;4978705;1554108;3424597
15/11/2004;33;RJ;600395729;709205540;-108809811
15/11/2004;24;RN;38282633;17024090;21258543
15/11/2004;43;RS;731551603;377684836;353866767
15/11/2004;11;RO;13009998;2219220;10790778
15/11/2004;14;RR;375646;242673;132973
15/11/2004;42;SC;414609798;144128512;270481286
15/11/2004;35;SP;2629163825;2556999392;72164433
15/11/2004;28;SE;3729660;6219191;-2489531
15/11/2004;17;TO;2025876;2582892;-557016
15/12/2004;12;AC;514237;15662;498575
15/12/2004;27;AL;74605236;3476615;71128621
15/12/2004;16;AP;2592596;556862;2035734
15/12/2004;13;AM;112096720;296958242;-184861522
15/12/2004;29;BA;419463822;333651029;85812793
15/12/2004;23;CE;86075696;46813651;39262045
15/12/2004;53;DF;1803251;46856270;-45053019
15/12/2004;32;ES;302013984;315307261;-13293277
15/12/2004;52;GO;86460464;58429049;28031415
15/12/2004;21;MA;116423631;88644578;27779053
15/12/2004;51;MT;192972259;43950674;149021585
15/12/2004;50;MS;48380874;71389829;-23008955
15/12/2004;31;MG;953010528;274790677;678219851
15/12/2004;15;PA;358513760;23602447;334911313
15/12/2004;25;PB;23135874;7926076;15209798
15/12/2004;41;PR;649241770;403668836;245572934
15/12/2004;26;PE;97528146;54396441;43131705
15/12/2004;22;PI;12427107;2111137;10315970
15/12/2004;33;RJ;508523097;713009252;-204486155
15/12/2004;24;RN;79650563;7748262;71902301
15/12/2004;43;RS;872967843;439349978;433617865
15/12/2004;11;RO;15706341;1260430;14445911
15/12/2004;14;RR;312300;270908;41392
15/12/2004;42;SC;468715402;172016125;296699277
15/12/2004;35;SP;3023526785;2259846399;763680386
15/12/2004;28;SE;3250680;8257506;-5006826
15/12/2004;17;TO;928766;493586;435180
15/01/2005;12;AC;839434;24508;814926
15/01/2005;27;AL;53025194;6491287;46533907
15/01/2005;16;AP;7246023;154033;7091990
15/01/2005;13;AM;103140992;342024684;-238883692
15/01/2005;29;BA;360550678;259133689;101416989
15/01/2005;23;CE;68999739;35661122;33338617
15/01/2005;53;DF;1830819;58992807;-57161988
15/01/2005;32;ES;397289966;274975467;122314499
15/01/2005;52;GO;74611973;59050916;15561057
15/01/2005;21;MA;95995452;59062415;36933037
15/01/2005;51;MT;155222249;20273907;134948342
15/01/2005;50;MS;43259767;20219659;23040108
15/01/2005;31;MG;830296932;272499320;557797612
15/01/2005;15;PA;374350621;22961246;351389375
15/01/2005;25;PB;13775719;6285854;7489865
15/01/2005;41;PR;533845049;398116454;135728595
15/01/2005;26;PE;66049770;45302301;20747469
15/01/2005;22;PI;2935103;1744626;1190477
15/01/2005;33;RJ;507709521;665696980;-157987459
15/01/2005;24;RN;23210114;7981860;15228254
15/01/2005;43;RS;739558203;294584142;444974061
15/01/2005;11;RO;8956485;1734334;7222151
15/01/2005;14;RR;488308;28315;459993
15/01/2005;42;SC;351838834;132147226;219691608
15/01/2005;35;SP;2461882882;2257731328;204151554
15/01/2005;28;SE;1257584;5802106;-4544522
15/01/2005;17;TO;630248;1045599;-415351
15/02/2005;12;AC;897439;0;897439
15/02/2005;27;AL;52072288;6012891;46059397
15/02/2005;16;AP;6470616;1185305;5285311
15/02/2005;13;AM;160093325;316905665;-156812340
15/02/2005;29;BA;332530601;195646254;136884347
15/02/2005;23;CE;68709332;26929655;41779677
15/02/2005;53;DF;2226445;33199741;-30973296
15/02/2005;32;ES;389021693;271941845;117079848
15/02/2005;52;GO;63675367;56161119;7514248
15/02/2005;21;MA;63803119;10601201;53201918
15/02/2005;51;MT;203844039;24602482;179241557
15/02/2005;50;MS;45990065;65348504;-19358439
15/02/2005;31;MG;964921991;244516924;720405067
15/02/2005;15;PA;337330842;24412868;312917974
15/02/2005;25;PB;21833139;5297324;16535815
15/02/2005;41;PR;600184132;360831533;239352599
15/02/2005;26;PE;60268284;55940776;4327508
15/02/2005;22;PI;3064332;774071;2290261
15/02/2005;33;RJ;453922804;712506382;-258583578
15/02/2005;24;RN;49505000;5606654;43898346
15/02/2005;43;RS;742564815;316979895;425584920
15/02/2005;11;RO;10742808;2875961;7866847
15/02/2005;14;RR;264196;38951;225245
15/02/2005;42;SC;423289921;132584702;290705219
15/02/2005;35;SP;2537167198;2094298255;442868943
15/02/2005;28;SE;4504554;6362710;-1858156
15/02/2005;17;TO;1023708;930734;92974
15/03/2005;12;AC;1296856;31232;1265624
15/03/2005;27;AL;96418163;5890829;90527334
15/03/2005;16;AP;2857916;3178500;-320584
15/03/2005;13;AM;206947003;388295591;-181348588
15/03/2005;29;BA;402594983;250391461;152203522
15/03/2005;23;CE;76137388;42087476;34049912
15/03/2005;53;DF;501850;63652208;-63150358
15/03/2005;32;ES;425766698;288764374;137002324
15/03/2005;52;GO;89775136;49275873;40499263
15/03/2005;21;MA;100556828;80034631;20522197
15/03/2005;51;MT;336909279;25076740;311832539
15/03/2005;50;MS;86228086;118810423;-32582337
15/03/2005;31;MG;1171115631;355257089;815858542
15/03/2005;15;PA;347258121;33150067;314108054
15/03/2005;25;PB;19976339;6808239;13168100
15/03/2005;41;PR;858729640;428450851;430278789
15/03/2005;26;PE;59067383;65279814;-6212431
15/03/2005;22;PI;3651092;981164;2669928
15/03/2005;33;RJ;459428029;555393067;-95965038
15/03/2005;24;RN;28016317;22331124;5685193
15/03/2005;43;RS;786305526;422075065;364230461
15/03/2005;11;RO;13781142;1318088;12463054
15/03/2005;14;RR;838032;25013;813019
15/03/2005;42;SC;477423680;174730786;302692894
15/03/2005;35;SP;2975273526;2513632567;461640959
15/03/2005;28;SE;3716328;4019246;-302918
15/03/2005;17;TO;1198823;548172;650651
15/04/2005;12;AC;1539674;37025;1502649
15/04/2005;27;AL;62775371;6988951;55786420
15/04/2005;16;AP;2767030;1243121;1523909
15/04/2005;13;AM;227625819;422958599;-195332780
15/04/2005;29;BA;360730776;140102657;220628119
15/04/2005;23;CE;77048112;67158718;9889394
15/04/2005;53;DF;2743907;41906058;-39162151
15/04/2005;32;ES;446923471;283563111;163360360
15/04/2005;52;GO;146373850;51078936;95294914
15/04/2005;21;MA;121763364;67936434;53826930
15/04/2005;51;MT;407655508;20174966;387480542
15/04/2005;50;MS;102732101;73761131;28970970
15/04/2005;31;MG;1054578399;287312623;767265776
15/04/2005;15;PA;356712647;19791267;336921380
15/04/2005;25;PB;19139013;6643993;12495020
15/04/2005;41;PR;896199330;372641674;523557656
15/04/2005;26;PE;67390842;68735788;-1344946
15/04/2005;22;PI;3361634;500092;2861542
15/04/2005;33;RJ;681439876;576218503;105221373
15/04/2005;24;RN;27484170;7418055;20066115
15/04/2005;43;RS;735643706;383099827;352543879
15/04/2005;11;RO;13714991;2052888;11662103
15/04/2005;14;RR;696672;102305;594367
15/04/2005;42;SC;457700652;133909333;323791319
15/04/2005;35;SP;2796991002;2276625282;520365720
15/04/2005;28;SE;2943838;8811771;-5867933
15/04/2005;17;TO;15134299;1513431;13620868
15/05/2005;12;AC;1091050;71272;1019778
15/05/2005;27;AL;56514766;6418316;50096450
15/05/2005;16;AP;7766039;2934778;4831261
15/05/2005;13;AM;175616646;399379133;-223762487
15/05/2005;29;BA;390368590;281717121;108651469
15/05/2005;23;CE;83041877;83954773;-912896
15/05/2005;53;DF;5322822;73056537;-67733715
15/05/2005;32;ES;438344738;342463047;95881691
15/05/2005;52;GO;169865570;48889935;120975635
15/05/2005;21;MA;99969436;113982395;-14012959
15/05/2005;51;MT;399146247;35854345;363291902
15/05/2005;50;MS;106050376;78617705;27432671
15/05/2005;31;MG;1137054476;337761973;799292503
15/05/2005;15;PA;440412611;19746133;420666478
15/05/2005;25;PB;19079826;7812560;11267266
15/05/2005;41;PR;900714975;443621483;457093492
15/05/2005;26;PE;62218270;93165765;-30947495
15/05/2005;22;PI;5041284;472293;4568991
15/05/2005;33;RJ;664774123;932756168;-267982045
15/05/2005;24;RN;23736030;8399270;15336760
15/05/2005;43;RS;857059764;375440051;481619713
15/05/2005;11;RO;20959310;1355905;19603405
15/05/2005;14;RR;584115;46316;537799
15/05/2005;42;SC;454525470;162789976;291735494
15/05/2005;35;SP;3122462462;2505952072;616510390
15/05/2005;28;SE;9749270;5759334;3989936
15/05/2005;17;TO;31227953;318882;30909071
15/06/2005;12;AC;461044;21477;439567
15/06/2005;27;AL;35427289;2791847;32635442
15/06/2005;16;AP;3983872;3973100;10772
15/06/2005;13;AM;189033266;439267625;-250234359
15/06/2005;29;BA;485299409;425269507;60029902
15/06/2005;23;CE;71400449;44842141;26558308
15/06/2005;53;DF;8683007;95132768;-86449761
15/06/2005;32;ES;530039270;340336275;189702995
15/06/2005;52;GO;236121510;66911511;169209999
15/06/2005;21;MA;115476736;31679243;83797493
15/06/2005;51;MT;428220806;49933829;378286977
15/06/2005;50;MS;119573691;80542272;39031419
15/06/2005;31;MG;1206439175;336056990;870382185
15/06/2005;15;PA;397171906;47931050;349240856
15/06/2005;25;PB;21332174;12054428;9277746
15/06/2005;41;PR;920828326;406661757;514166569
15/06/2005;26;PE;44557075;59731303;-15174228
15/06/2005;22;PI;7658941;511785;7147156
15/06/2005;33;RJ;372732497;607299407;-234566910
15/06/2005;24;RN;18062200;6097863;11964337
15/06/2005;43;RS;943197092;430033612;513163480
15/06/2005;11;RO;34745361;689175;34056186
15/06/2005;14;RR;591506;52592;538914
15/06/2005;42;SC;485933340;175456009;310477331
15/06/2005;35;SP;3271242774;2483142794;788099980
15/06/2005;28;SE;11491102;10151651;1339451
15/06/2005;17;TO;29349798;1505539;27844259
15/07/2005;12;AC;593512;43979;549533
15/07/2005;27;AL;46900182;12186550;34713632
15/07/2005;16;AP;1284792;1004899;279893
15/07/2005;13;AM;171680135;474115672;-302435537
15/07/2005;29;BA;688789942;208401684;480388258
15/07/2005;23;CE;78796941;35511644;43285297
15/07/2005;53;DF;7230544;45439608;-38209064
15/07/2005;32;ES;485709890;315579403;170130487
15/07/2005;52;GO;202490682;54641717;147848965
15/07/2005;21;MA;177599505;30475045;147124460
15/07/2005;51;MT;420528317;65334088;355194229
15/07/2005;50;MS;134720301;78604602;56115699
15/07/2005;31;MG;1129241038;309778840;819462198
15/07/2005;15;PA;394711806;31125473;363586333
15/07/2005;25;PB;17487774;8311192;9176582
15/07/2005;41;PR;936130639;335620305;600510334
15/07/2005;26;PE;36910502;57057152;-20146650
15/07/2005;22;PI;5657497;1391346;4266151
15/07/2005;33;RJ;963236719;772105406;191131313
15/07/2005;24;RN;43141937;5673130;37468807
15/07/2005;43;RS;1032736054;418530915;614205139
15/07/2005;11;RO;20074464;1646536;18427928
15/07/2005;14;RR;361733;71628;290105
15/07/2005;42;SC;501931090;178821728;323109362
15/07/2005;35;SP;3349843039;2597811241;752031798
15/07/2005;28;SE;7235253;7068571;166682
15/07/2005;17;TO;24770231;2098150;22672081
15/08/2005;12;AC;528313;133308;395005
15/08/2005;27;AL;8618128;13986203;-5368075
15/08/2005;16;AP;5969260;297280;5671980
15/08/2005;13;AM;156428770;546780783;-390352013
15/08/2005;29;BA;689403364;351921376;337481988
15/08/2005;23;CE;83523624;33242111;50281513
15/08/2005;53;DF;6721437;62422622;-55701185
15/08/2005;32;ES;440154407;376097015;64057392
15/08/2005;52;GO;211236761;65427210;145809551
15/08/2005;21;MA;160844866;417886927;-257042061
15/08/2005;51;MT;447334385;62026656;385307729
15/08/2005;50;MS;145796900;98795052;47001848
15/08/2005;31;MG;1209673159;400220536;809452623
15/08/2005;15;PA;375899764;35995469;339904295
15/08/2005;25;PB;16562723;7642277;8920446
15/08/2005;41;PR;965123249;385420141;579703108
15/08/2005;26;PE;42965860;76686933;-33721073
15/08/2005;22;PI;7479336;1246118;6233218
15/08/2005;33;RJ;776855600;933204847;-156349247
15/08/2005;24;RN;75848774;12020481;63828293
15/08/2005;43;RS;1063377567;471446503;591931064
15/08/2005;11;RO;20124994;1348951;18776043
15/08/2005;14;RR;379986;85809;294177
15/08/2005;42;SC;496106221;217993403;278112818
15/08/2005;35;SP;3723932676;3105174708;618757968
15/08/2005;28;SE;4715535;6635946;-1920411
15/08/2005;17;TO;13302507;916882;12385625
15/09/2005;12;AC;633790;18704;615086
15/09/2005;27;AL;9768431;5288302;4480129
15/09/2005;16;AP;9351102;860273;8490829
15/09/2005;13;AM;189849375;526374865;-336525490
15/09/2005;29;BA;533449071;279161944;254287127
15/09/2005;23;CE;85421265;57985403;27435862
15/09/2005;53;DF;7752748;63591077;-55838329
15/09/2005;32;ES;436818100;338251064;98567036
15/09/2005;52;GO;161533198;86283536;75249662
15/09/2005;21;MA;144746408;127117119;17629289
15/09/2005;51;MT;406718477;53268065;353450412
15/09/2005;50;MS;110975748;102906647;8069101
15/09/2005;31;MG;1087220883;380482847;706738036
15/09/2005;15;PA;399104060;50232243;348871817
15/09/2005;25;PB;16791396;11588987;5202409
15/09/2005;41;PR;824164517;343900407;480264110
15/09/2005;26;PE;58165504;58997262;-831758
15/09/2005;22;PI;8649267;1382158;7267109
15/09/2005;33;RJ;854923299;561110782;293812517
15/09/2005;24;RN;22943220;9045282;13897938
15/09/2005;43;RS;875269467;370940480;504328987
15/09/2005;11;RO;12757003;2016758;10740245
15/09/2005;14;RR;864043;28898;835145
15/09/2005;42;SC;468628825;202468059;266160766
15/09/2005;35;SP;3718816339;2658042022;1060774317
15/09/2005;28;SE;4101414;9963975;-5862561
15/09/2005;17;TO;9696213;1435020;8261193
15/10/2005;12;AC;429093;26736;402357
15/10/2005;27;AL;17300355;12989003;4311352
15/10/2005;16;AP;3404720;384000;3020720
15/10/2005;13;AM;198294450;469024703;-270730253
15/10/2005;29;BA;493737303;192573170;301164133
15/10/2005;23;CE;72539151;73227718;-688567
15/10/2005;53;DF;4741630;60379963;-55638333
15/10/2005;32;ES;515625536;329022145;186603391
15/10/2005;52;GO;160644490;67411253;93233237
15/10/2005;21;MA;131262157;133229128;-1966971
15/10/2005;51;MT;349988533;27275424;322713109
15/10/2005;50;MS;95060035;96268732;-1208697
15/10/2005;31;MG;1124633605;294885685;829747920
15/10/2005;15;PA;413584955;32548323;381036632
15/10/2005;25;PB;23222389;6346082;16876307
15/10/2005;41;PR;839594571;306116967;533477604
15/10/2005;26;PE;99386289;55009622;44376667
15/10/2005;22;PI;4175392;3467752;707640
15/10/2005;33;RJ;624400076;742026281;-117626205
15/10/2005;24;RN;32275216;8580525;23694691
15/10/2005;43;RS;809849518;440977616;368871902
15/10/2005;11;RO;15395379;2509770;12885609
15/10/2005;14;RR;826219;76692;749527
15/10/2005;42;SC;487989507;188688063;299301444
15/10/2005;35;SP;3187577753;2669271303;518306450
15/10/2005;28;SE;4700681;4885586;-184905
15/10/2005;17;TO;14177168;921342;13255826
15/11/2005;12;AC;1801660;48298;1753362
15/11/2005;27;AL;71467331;10883200;60584131
15/11/2005;16;AP;3321594;907657;2413937
15/11/2005;13;AM;188932198;489475183;-300542985
15/11/2005;29;BA;673707391;319576069;354131322
15/11/2005;23;CE;80821690;52974855;27846835
15/11/2005;53;DF;4725910;55498682;-50772772
15/11/2005;32;ES;561637215;371917723;189719492
15/11/2005;52;GO;142279371;65505121;76774250
15/11/2005;21;MA;143352910;40072822;103280088
15/11/2005;51;MT;299288043;18772246;280515797
15/11/2005;50;MS;75636240;123082698;-47446458
15/11/2005;31;MG;1266314019;409474121;856839898
15/11/2005;15;PA;427135593;39675507;387460086
15/11/2005;25;PB;16423208;6941948;9481260
15/11/2005;41;PR;914036139;396033589;518002550
15/11/2005;26;PE;93045752;87809463;5236289
15/11/2005;22;PI;3010315;1078347;1931968
15/11/2005;33;RJ;954293948;666269564;288024384
15/11/2005;24;RN;36841946;9075010;27766936
15/11/2005;43;RS;864156059;411471521;452684538
15/11/2005;11;RO;11864872;6464569;5400303
15/11/2005;14;RR;1975392;65079;1910313
15/11/2005;42;SC;452445207;210103059;242342148
15/11/2005;35;SP;3346504491;2898582833;447921658
15/11/2005;28;SE;5533977;5481063;52914
15/11/2005;17;TO;4872441;334521;4537920
15/12/2005;12;AC;1227968;44778;1183190
15/12/2005;27;AL;73491558;7477467;66014091
15/12/2005;16;AP;22088195;460195;21628000
15/12/2005;13;AM;176072394;365040559;-188968165
15/12/2005;29;BA;572509747;354010600;218499147
15/12/2005;23;CE;83223517;36838085;46385432
15/12/2005;53;DF;7140789;89409511;-82268722
15/12/2005;32;ES;523565703;392648044;130917659
15/12/2005;52;GO;151634768;56892254;94742514
15/12/2005;21;MA;138652138;44590061;94062077
15/12/2005;51;MT;282390449;20635261;261755188
15/12/2005;50;MS;79087673;122107279;-43019606
15/12/2005;31;MG;1309049670;319870219;989179451
15/12/2005;15;PA;492584825;47218547;445366278
15/12/2005;25;PB;22098184;8349016;13749168
15/12/2005;41;PR;817489502;350805748;466683754
15/12/2005;26;PE;93838998;81811802;12027196
15/12/2005;22;PI;3922204;1379828;2542376
15/12/2005;33;RJ;812678711;823059675;-10380964
15/12/2005;24;RN;32042206;10106897;21935309
15/12/2005;43;RS;996203393;471519609;524683784
15/12/2005;11;RO;19489259;3636333;15852926
15/12/2005;14;RR;613055;243756;369299
15/12/2005;42;SC;523025521;231110215;291915306
15/12/2005;35;SP;3462157052;2695865293;766291759
15/12/2005;28;SE;6474349;14134270;-7659921
15/12/2005;17;TO;7041407;1807320;5234087
15/01/2006;12;AC;2050122;432525;1617597
15/01/2006;27;AL;79829914;11690728;68139186
15/01/2006;16;AP;4021459;433442;3588017
15/01/2006;13;AM;101359451;429572587;-328213136
15/01/2006;29;BA;510908982;319464808;191444174
15/01/2006;23;CE;77004424;59600291;17404133
15/01/2006;53;DF;3985847;82154411;-78168564
15/01/2006;32;ES;447780656;357605295;90175361
15/01/2006;52;GO;106671506;57775815;48895691
15/01/2006;21;MA;154798837;188265044;-33466207
15/01/2006;51;MT;258992717;24014880;234977837
15/01/2006;50;MS;55458821;127859543;-72400722
15/01/2006;31;MG;1084251368;355400743;728850625
15/01/2006;15;PA;456828691;46252162;410576529
15/01/2006;25;PB;12798567;11836980;961587
15/01/2006;41;PR;607024052;397379797;209644255
15/01/2006;26;PE;58502397;72875281;-14372884
15/01/2006;22;PI;2990632;2688861;301771
15/01/2006;33;RJ;1150750538;654029785;496720753
15/01/2006;24;RN;33919801;15829486;18090315
15/01/2006;43;RS;612263456;408396533;203866923
15/01/2006;11;RO;13996749;4354080;9642669
15/01/2006;14;RR;7382831;5546;7377285
15/01/2006;42;SC;403153778;242735497;160418281
15/01/2006;35;SP;2883195091;2564300397;318894694
15/01/2006;28;SE;3194647;4846062;-1651415
15/01/2006;17;TO;3356946;1267847;2089099
15/02/2006;12;AC;2429404;77832;2351572
15/02/2006;27;AL;75064133;7039082;68025051
15/02/2006;16;AP;14056485;907338;13149147
15/02/2006;13;AM;148086667;417088185;-269001518
15/02/2006;29;BA;353981650;258766035;95215615
15/02/2006;23;CE;81371624;58770633;22600991
15/02/2006;53;DF;2114454;66120151;-64005697
15/02/2006;32;ES;467738147;320182130;147556017
15/02/2006;52;GO;85217098;66914198;18302900
15/02/2006;21;MA;112286093;135206777;-22920684
15/02/2006;51;MT;249118855;22079355;227039500
15/02/2006;50;MS;38609928;121270028;-82660100
15/02/2006;31;MG;1028821833;297880745;730941088
15/02/2006;15;PA;406762254;55958569;350803685
15/02/2006;25;PB;11741538;18025444;-6283906
15/02/2006;41;PR;628355705;351387223;276968482
15/02/2006;26;PE;68131985;65491650;2640335
15/02/2006;22;PI;3268283;1546949;1721334
15/02/2006;33;RJ;635903557;711407360;-75503803
15/02/2006;24;RN;26689273;9903804;16785469
15/02/2006;43;RS;754994721;372745495;382249226
15/02/2006;11;RO;10920196;5717081;5203115
15/02/2006;14;RR;531370;342406;188964
15/02/2006;42;SC;422592317;224082205;198510112
15/02/2006;35;SP;2903469249;2367228026;536241223
15/02/2006;28;SE;3073335;4482463;-1409128
15/02/2006;17;TO;2191353;1951748;239605
15/03/2006;12;AC;2016472;499784;1516688
15/03/2006;27;AL;118498594;7951978;110546616
15/03/2006;16;AP;26152198;1271504;24880694
15/03/2006;13;AM;185470450;633826629;-448356179
15/03/2006;29;BA;591712935;355265726;236447209
15/03/2006;23;CE;74525443;39049210;35476233
15/03/2006;53;DF;3115697;64290570;-61174873
15/03/2006;32;ES;634139493;423802711;210336782
15/03/2006;52;GO;213282316;79878502;133403814
15/03/2006;21;MA;123857666;150978415;-27120749
15/03/2006;51;MT;522585454;21169457;501415997
15/03/2006;50;MS;98554061;132067550;-33513489
15/03/2006;31;MG;1282565359;368461475;914103884
15/03/2006;15;PA;536737457;79368841;457368616
15/03/2006;25;PB;18532981;13188155;5344826
15/03/2006;41;PR;856688164;563564814;293123350
15/03/2006;26;PE;67186169;80487814;-13301645
15/03/2006;22;PI;3612759;219131;3393628
15/03/2006;33;RJ;667761337;751779199;-84017862
15/03/2006;24;RN;21721205;12711350;9009855
15/03/2006;43;RS;841661838;481243603;360418235
15/03/2006;11;RO;18903089;7237204;11665885
15/03/2006;14;RR;1475084;161590;1313494
15/03/2006;42;SC;496078514;266282124;229796390
15/03/2006;35;SP;3779413836;3157856232;621557604
15/03/2006;28;SE;4330610;9657918;-5327308
15/03/2006;17;TO;2992208;1375743;1616465
15/04/2006;12;AC;1784316;238908;1545408
15/04/2006;27;AL;71698559;4813579;66884980
15/04/2006;16;AP;8521856;649602;7872254
15/04/2006;13;AM;108003853;535140503;-427136650
15/04/2006;29;BA;515537159;350644783;164892376
15/04/2006;23;CE;72602514;141645171;-69042657
15/04/2006;53;DF;2820094;46405238;-43585144
15/04/2006;32;ES;442359358;311625801;130733557
15/04/2006;52;GO;169211182;73590137;95621045
15/04/2006;21;MA;113323401;91233969;22089432
15/04/2006;51;MT;381635896;20911769;360724127
15/04/2006;50;MS;79535804;127016809;-47481005
15/04/2006;31;MG;1000251467;341092343;659159124
15/04/2006;15;PA;385145839;72482000;312663839
15/04/2006;25;PB;18723528;7500468;11223060
15/04/2006;41;PR;782046456;373871463;408174993
15/04/2006;26;PE;67370150;75525458;-8155308
15/04/2006;22;PI;4095797;722623;3373174
15/04/2006;33;RJ;804437782;645371737;159066045
15/04/2006;24;RN;57310817;11269850;46040967
15/04/2006;43;RS;807637361;458809031;348828330
15/04/2006;11;RO;21515395;3258549;18256846
15/04/2006;14;RR;841425;67569;773856
15/04/2006;42;SC;456779498;234118552;222660946
15/04/2006;35;SP;3202226159;2798597735;403628424
15/04/2006;28;SE;3970692;6834874;-2864182
15/04/2006;17;TO;28037468;1362926;26674542
15/05/2006;12;AC;1677159;122561;1554598
15/05/2006;27;AL;20131318;8576294;11555024
15/05/2006;16;AP;14101984;556164;13545820
15/05/2006;13;AM;146196669;592307580;-446110911
15/05/2006;29;BA;525996525;339900629;186095896
15/05/2006;23;CE;76671188;47220533;29450655
15/05/2006;53;DF;4156748;39337605;-35180857
15/05/2006;32;ES;387796723;298026564;89770159
15/05/2006;52;GO;248288507;64567946;183720561
15/05/2006;21;MA;96318834;10290365;86028469
15/05/2006;51;MT;338633679;6386952;332246727
15/05/2006;50;MS;76762986;124862064;-48099078
15/05/2006;31;MG;1126371338;310902698;815468640
15/05/2006;15;PA;432250663;44386201;387864462
15/05/2006;25;PB;16907764;8460688;8447076
15/05/2006;41;PR;687529135;303810543;383718592
15/05/2006;26;PE;51177237;102814561;-51637324
15/05/2006;22;PI;4118178;777635;3340543
15/05/2006;33;RJ;629317842;842782505;-213464663
15/05/2006;24;RN;17068176;14354085;2714091
15/05/2006;43;RS;1009233463;518704504;490528959
15/05/2006;11;RO;34966873;2997208;31969665
15/05/2006;14;RR;944390;55610;888780
15/05/2006;42;SC;515051753;239784410;275267343
15/05/2006;35;SP;3599959539;3335441091;264518448
15/05/2006;28;SE;3893363;12480341;-8586978
15/05/2006;17;TO;17285323;2406181;14879142
15/06/2006;12;AC;2142568;78948;2063620
15/06/2006;27;AL;43030732;7071899;35958833
15/06/2006;16;AP;13216322;577914;12638408
15/06/2006;13;AM;123614601;579441935;-455827334
15/06/2006;29;BA;562490533;382551805;179938728
15/06/2006;23;CE;82354922;45487342;36867580
15/06/2006;53;DF;11649592;60596384;-48946792
15/06/2006;32;ES;633949384;432488715;201460669
15/06/2006;52;GO;232896345;78397207;154499138
15/06/2006;21;MA;77614335;170307531;-92693196
15/06/2006;51;MT;252525103;16575200;235949903
15/06/2006;50;MS;72044110;133988825;-61944715
15/06/2006;31;MG;1425938135;405136607;1020801528
15/06/2006;15;PA;455493909;52973974;402519935
15/06/2006;25;PB;14330326;11635380;2694946
15/06/2006;41;PR;721376766;323987753;397389013
15/06/2006;26;PE;43441504;110429584;-66988080
15/06/2006;22;PI;3675026;4552733;-877707
15/06/2006;33;RJ;840859803;842045561;-1185758
15/06/2006;24;RN;24704333;8792939;15911394
15/06/2006;43;RS;1033573917;425497261;608076656
15/06/2006;11;RO;34507010;4251126;30255884
15/06/2006;14;RR;903647;25312;878335
15/06/2006;42;SC;487726821;202070122;285656699
15/06/2006;35;SP;4051460165;3045709239;1005750926
15/06/2006;28;SE;5833573;7045856;-1212283
15/06/2006;17;TO;21793925;1015024;20778901
15/07/2006;12;AC;1136449;0;1136449
15/07/2006;27;AL;20126137;6226764;13899373
15/07/2006;16;AP;10021523;741396;9280127
15/07/2006;13;AM;138309805;556408881;-418099076
15/07/2006;29;BA;620100928;497673604;122427324
15/07/2006;23;CE;76502451;71119015;5383436
15/07/2006;53;DF;6987640;81191870;-74204230
15/07/2006;32;ES;624402277;380845160;243557117
15/07/2006;52;GO;235255748;91441680;143814068
15/07/2006;21;MA;189862952;124751727;65111225
15/07/2006;51;MT;475986966;37897685;438089281
15/07/2006;50;MS;104902992;143723840;-38820848
15/07/2006;31;MG;1490975633;518987997;971987636
15/07/2006;15;PA;863558535;89369139;774189396
15/07/2006;25;PB;20518677;19166672;1352005
15/07/2006;41;PR;1115100197;643648493;471451704
15/07/2006;26;PE;47774322;98072230;-50297908
15/07/2006;22;PI;3475653;2002983;1472670
15/07/2006;33;RJ;1213418711;862731183;350687528
15/07/2006;24;RN;20537904;15583017;4954887
15/07/2006;43;RS;1356278842;519077180;837201662
15/07/2006;11;RO;29131596;3648870;25482726
15/07/2006;14;RR;748008;24383;723625
15/07/2006;42;SC;522818223;309641847;213176376
15/07/2006;35;SP;4209667233;2886174461;1323492772
15/07/2006;28;SE;11287191;11577779;-290588
15/07/2006;17;TO;49412079;1849661;47562418
15/08/2006;12;AC;772590;116561;656029
15/08/2006;27;AL;5068105;8382146;-3314041
15/08/2006;16;AP;2563290;817107;1746183
15/08/2006;13;AM;153306405;541827060;-388520655
15/08/2006;29;BA;654471367;409782377;244688990
15/08/2006;23;CE;93537707;145470992;-51933285
15/08/2006;53;DF;8262594;88508020;-80245426
15/08/2006;32;ES;630399803;424961388;205438415
15/08/2006;52;GO;199518234;108846241;90671993
15/08/2006;21;MA;211221588;87753415;123468173
15/08/2006;51;MT;469935887;101182496;368753391
15/08/2006;50;MS;119610508;165594122;-45983614
15/08/2006;31;MG;1579278592;449948374;1129330218
15/08/2006;15;PA;590669361;37871398;552797963
15/08/2006;25;PB;12341945;15718608;-3376663
15/08/2006;41;PR;1113329002;848137541;265191461
15/08/2006;26;PE;40849621;78069978;-37220357
15/08/2006;22;PI;7512968;5521006;1991962
15/08/2006;33;RJ;1104368134;858796299;245571835
15/08/2006;24;RN;22534890;10348651;12186239
15/08/2006;43;RS;1211482375;592162258;619320117
15/08/2006;11;RO;41092947;3688196;37404751
15/08/2006;14;RR;697431;66172;631259
15/08/2006;42;SC;591865617;338663471;253202146
15/08/2006;35;SP;4564046293;3767043921;797002372
15/08/2006;28;SE;9867908;6972609;2895299
15/08/2006;17;TO;32410512;3162541;29247971
15/09/2006;12;AC;1145683;292029;853654
15/09/2006;27;AL;11580043;9895871;1684172
15/09/2006;16;AP;7944554;1144879;6799675
15/09/2006;13;AM;130586229;540539868;-409953639
15/09/2006;29;BA;660494555;401199848;259294707
15/09/2006;23;CE;81202839;123214074;-42011235
15/09/2006;53;DF;2777022;87221247;-84444225
15/09/2006;32;ES;543461230;392508231;150952999
15/09/2006;52;GO;156574508;96915188;59659320
15/09/2006;21;MA;158244470;198006694;-39762224
15/09/2006;51;MT;377724391;39790115;337934276
15/09/2006;50;MS;100726079;155850262;-55124183
15/09/2006;31;MG;1449760282;387120423;1062639859
15/09/2006;15;PA;654105994;49022988;605083006
15/09/2006;25;PB;14946734;11787315;3159419
15/09/2006;41;PR;854293697;451789361;402504336
15/09/2006;26;PE;45864480;84710042;-38845562
15/09/2006;22;PI;3068747;1704873;1363874
15/09/2006;33;RJ;1382109004;849785459;532323545
15/09/2006;24;RN;23802210;11038848;12763362
15/09/2006;43;RS;1051608333;461157071;590451262
15/09/2006;11;RO;27153125;5114441;22038684
15/09/2006;14;RR;701436;35296;666140
15/09/2006;42;SC;520590197;332993625;187596572
15/09/2006;35;SP;4087790275;3393989580;693800695
15/09/2006;28;SE;9363878;6487501;2876377
15/09/2006;17;TO;15346230;3782776;11563454
15/10/2006;12;AC;1018491;25026;993465
15/10/2006;27;AL;36383550;6676956;29706594
15/10/2006;16;AP;11159613;1463449;9696164
15/10/2006;13;AM;111714830;535968904;-424254074
15/10/2006;29;BA;600850560;360498459;240352101
15/10/2006;23;CE;79454533;167161220;-87706687
15/10/2006;53;DF;5135209;76365561;-71230352
15/10/2006;32;ES;758464089;445738620;312725469
15/10/2006;52;GO;166398950;94541916;71857034
15/10/2006;21;MA;181072469;89104758;91967711
15/10/2006;51;MT;407811234;65941671;341869563
15/10/2006;50;MS;94629768;172321889;-77692121
15/10/2006;31;MG;1375675910;515572814;860103096
15/10/2006;15;PA;630840574;38443400;592397174
15/10/2006;25;PB;20697325;12430545;8266780
15/10/2006;41;PR;863630157;614297345;249332812
15/10/2006;26;PE;96949078;85167705;11781373
15/10/2006;22;PI;4021421;2061619;1959802
15/10/2006;33;RJ;994331973;772227628;222104345
15/10/2006;24;RN;40913254;11106687;29806567
15/10/2006;43;RS;990340964;637709038;352631926
15/10/2006;11;RO;26898261;5933448;20964813
15/10/2006;14;RR;422478;211877;210601
15/10/2006;42;SC;508780615;341137526;167643089
15/10/2006;35;SP;4397768305;3661457697;736310608
15/10/2006;28;SE;7482720;4260350;3222370
15/10/2006;17;TO;18700002;2506500;16193502
15/11/2006;12;AC;810009;35868;774141
15/11/2006;27;AL;81023089;24863548;56159541
15/11/2006;16;AP;8638482;1086452;7552030
15/11/2006;13;AM;103758945;457780380;-354021435
15/11/2006;29;BA;508577890;409177734;99400156
15/11/2006;23;CE;80603513;109679224;-29075711
15/11/2006;53;DF;7645643;80836937;-73191294
15/11/2006;32;ES;590906146;470035080;120871066
15/11/2006;52;GO;157173238;87066383;70106855
15/11/2006;21;MA;167374557;314227344;-146852787
15/11/2006;51;MT;342290505;30197164;312093341
15/11/2006;50;MS;95079139;167095481;-72016342
15/11/2006;31;MG;1414450801;467572695;946878106
15/11/2006;15;PA;716440967;30126317;686314650
15/11/2006;25;PB;23896270;24557803;-661533
15/11/2006;41;PR;817595994;633050581;184545413
15/11/2006;26;PE;93995723;82797848;11197875
15/11/2006;22;PI;3362658;3152044;210614
15/11/2006;33;RJ;940385379;986751107;-46365728
15/11/2006;24;RN;45292065;9958207;35333858
15/11/2006;43;RS;999239484;443348771;555890713
15/11/2006;11;RO;26438012;7948667;18489345
15/11/2006;14;RR;318858;172243;146615
15/11/2006;42;SC;548869317;341530241;207339076
15/11/2006;35;SP;3885910712;3455865927;430044785
15/11/2006;28;SE;9622271;9090926;531345
15/11/2006;17;TO;3938880;2190271;1748609
15/12/2006;12;AC;812706;102180;710526
15/12/2006;27;AL;130108188;13045461;117062727
15/12/2006;16;AP;7582241;1165148;6417093
15/12/2006;13;AM;66322461;370352165;-304029704
15/12/2006;29;BA;661488903;327029756;334459147
15/12/2006;23;CE;79981955;90859789;-10877834
15/12/2006;53;DF;7009441;84524284;-77514843
15/12/2006;32;ES;539030239;421986845;117043394
15/12/2006;52;GO;118768400;95251223;23517177
15/12/2006;21;MA;123079652;165605727;-42526075
15/12/2006;51;MT;252209769;25231241;226978528
15/12/2006;50;MS;68063962;148487994;-80424032
15/12/2006;31;MG;1375814444;458990733;916823711
15/12/2006;15;PA;576965883;48098233;528867650
15/12/2006;25;PB;23153432;15212952;7940480
15/12/2006;41;PR;931653269;484650235;447003034
15/12/2006;26;PE;98832966;83526957;15306009
15/12/2006;22;PI;3924973;1671923;2253050
15/12/2006;33;RJ;1064884186;581346427;483537759
15/12/2006;24;RN;36983135;11264963;25718172
15/12/2006;43;RS;1041242534;544657483;496585051
15/12/2006;11;RO;21900835;8019960;13880875
15/12/2006;14;RR;391489;49926;341563
15/12/2006;42;SC;519600112;317651366;201948746
15/12/2006;35;SP;4297697276;2878388272;1419309004
15/12/2006;28;SE;7018985;4198925;2820060
15/12/2006;17;TO;7995719;1847425;6148294
15/01/2007;12;AC;562351;26251;536100
15/01/2007;27;AL;139819243;6515816;133303427
15/01/2007;16;AP;7962385;571926;7390459
15/01/2007;13;AM;68052806;437412224;-369359418
15/01/2007;29;BA;507038672;381566892;125471780
15/01/2007;23;CE;95547414;69150311;26397103
15/01/2007;53;DF;3716626;188424672;-184708046
15/01/2007;32;ES;535272928;471536771;63736157
15/01/2007;52;GO;116533870;89577712;26956158
15/01/2007;21;MA;177259856;170133634;7126222
15/01/2007;51;MT;256261370;47665058;208596312
15/01/2007;50;MS;69438365;153160904;-83722539
15/01/2007;31;MG;1468395435;491917444;976477991
15/01/2007;15;PA;625362499;43695715;581666784
15/01/2007;25;PB;20123495;22514709;-2391214
15/01/2007;41;PR;658275110;475457053;182818057
15/01/2007;26;PE;65081094;109104994;-44023900
15/01/2007;22;PI;3888316;2124444;1763872
15/01/2007;33;RJ;976040594;784423844;191616750
15/01/2007;24;RN;38660903;8230143;30430760
15/01/2007;43;RS;850899501;413513125;437386376
15/01/2007;11;RO;21868694;7864675;14004019
15/01/2007;14;RR;3161058;11367;3149691
15/01/2007;42;SC;385034891;348128028;36906863
15/01/2007;35;SP;3660242610;3689683095;-29440485
15/01/2007;28;SE;11819486;21854250;-10034764
15/01/2007;17;TO;4327246;3996716;330530
15/02/2007;12;AC;717431;95372;622059
15/02/2007;27;AL;97478758;8650131;88828627
15/02/2007;16;AP;15766521;272938;15493583
15/02/2007;13;AM;54145584;448266736;-394121152
15/02/2007;29;BA;479624225;343834941;135789284
15/02/2007;23;CE;82030036;65208312;16821724
15/02/2007;53;DF;5596669;57528405;-51931736
15/02/2007;32;ES;480733558;369557206;111176352
15/02/2007;52;GO;133066742;92067274;40999468
15/02/2007;21;MA;159120731;104652577;54468154
15/02/2007;51;MT;245929981;47343793;198586188
15/02/2007;50;MS;50490884;142183144;-91692260
15/02/2007;31;MG;1307492725;349462879;958029846
15/02/2007;15;PA;569387502;22320180;547067322
15/02/2007;25;PB;19299091;16981652;2317439
15/02/2007;41;PR;760108911;540497976;219610935
15/02/2007;26;PE;65890226;105966203;-40075977
15/02/2007;22;PI;5275212;4741847;533365
15/02/2007;33;RJ;797484626;736239908;61244718
15/02/2007;24;RN;28016380;10554870;17461510
15/02/2007;43;RS;850799178;492260377;358538801
15/02/2007;11;RO;26214695;5291698;20922997
15/02/2007;14;RR;1904312;117572;1786740
15/02/2007;42;SC;484618903;316220499;168398404
15/02/2007;35;SP;3239824977;2922830116;316994861
15/02/2007;28;SE;8576290;12529097;-3952807
15/02/2007;17;TO;4343955;3139500;1204455
15/03/2007;12;AC;1717665;944322;773343
15/03/2007;27;AL;83149449;29502143;53647306
15/03/2007;16;AP;2190787;1919247;271540
15/03/2007;13;AM;75264781;566131710;-490866929
15/03/2007;29;BA;562589972;565189167;-2599195
15/03/2007;23;CE;86719038;57956685;28762353
15/03/2007;53;DF;4318832;48177229;-43858397
15/03/2007;32;ES;520396021;449089392;71306629
15/03/2007;52;GO;243599082;109609632;133989450
15/03/2007;21;MA;162505016;139055350;23449666
15/03/2007;51;MT;425615503;53206756;372408747
15/03/2007;50;MS;82519308;161469656;-78950348
15/03/2007;31;MG;1482295890;556866850;925429040
15/03/2007;15;PA;605391034;39898427;565492607
15/03/2007;25;PB;15113455;29430339;-14316884
15/03/2007;41;PR;1003020830;749812903;253207927
15/03/2007;26;PE;74063376;136421835;-62358459
15/03/2007;22;PI;4665371;4260848;404523
15/03/2007;33;RJ;1141344728;829309844;312034884
15/03/2007;24;RN;29619217;15181452;14437765
15/03/2007;43;RS;1056477316;581894899;474582417
15/03/2007;11;RO;34261210;8072169;26189041
15/03/2007;14;RR;734670;107038;627632
15/03/2007;42;SC;642508932;388173047;254335885
15/03/2007;35;SP;4303271454;3967123923;336147531
15/03/2007;28;SE;15552987;9336894;6216093
15/03/2007;17;TO;3857362;5197166;-1339804
15/04/2007;12;AC;2202355;85200;2117155
15/04/2007;27;AL;77497681;6977047;70520634
15/04/2007;16;AP;16006138;2781832;13224306
15/04/2007;13;AM;83705946;522073876;-438367930
15/04/2007;29;BA;589265366;349783414;239481952
15/04/2007;23;CE;79270313;70393315;8876998
15/04/2007;53;DF;9032728;90524957;-81492229
15/04/2007;32;ES;531284385;400871025;130413360
15/04/2007;52;GO;315397279;115270755;200126524
15/04/2007;21;MA;201592936;151514873;50078063
15/04/2007;51;MT;521522200;57019320;464502880
15/04/2007;50;MS;167657618;159207830;8449788
15/04/2007;31;MG;1310753412;445616462;865136950
15/04/2007;15;PA;599371848;48675113;550696735
15/04/2007;25;PB;19895321;29203349;-9308028
15/04/2007;41;PR;1027312080;509711301;517600779
15/04/2007;26;PE;44970054;117636935;-72666881
15/04/2007;22;PI;5066317;2212862;2853455
15/04/2007;33;RJ;1092361722;822544225;269817497
15/04/2007;24;RN;24646091;12228627;12417464
15/04/2007;43;RS;955412777;596590113;358822664
15/04/2007;11;RO;33635360;6225044;27410316
15/04/2007;14;RR;400734;43317;357417
15/04/2007;42;SC;603493743;343615495;259878248
15/04/2007;35;SP;3860880819;3376466517;484414302
15/04/2007;28;SE;17636481;7469485;10166996
15/04/2007;17;TO;14362474;3718731;10643743
15/05/2007;12;AC;2151828;30140;2121688
15/05/2007;27;AL;63566021;19782546;43783475
15/05/2007;16;AP;12960984;2357227;10603757
15/05/2007;13;AM;96541947;582981282;-486439335
15/05/2007;29;BA;563852007;405454831;158397176
15/05/2007;23;CE;93578203;77882850;15695353
15/05/2007;53;DF;9174219;106667288;-97493069
15/05/2007;32;ES;603328384;490472756;112855628
15/05/2007;52;GO;315913219;109150507;206762712
15/05/2007;21;MA;201235274;117049481;84185793
15/05/2007;51;MT;463495552;82768928;380726624
15/05/2007;50;MS;119812719;162668801;-42856082
15/05/2007;31;MG;1487810965;533016313;954794652
15/05/2007;15;PA;590556631;50346149;540210482
15/05/2007;25;PB;18833632;22159705;-3326073
15/05/2007;41;PR;1084290512;742843226;341447286
15/05/2007;26;PE;68044663;131728338;-63683675
15/05/2007;22;PI;3978683;2316009;1662674
15/05/2007;33;RJ;983733697;1007834860;-24101163
15/05/2007;24;RN;24343685;11062286;13281399
15/05/2007;43;RS;1376482588;596216905;780265683
15/05/2007;11;RO;42981845;6880129;36101716
15/05/2007;14;RR;567382;84446;482936
15/05/2007;42;SC;662163342;419459162;242704180
15/05/2007;35;SP;4511114358;4072214965;438899393
15/05/2007;28;SE;13453418;16360838;-2907420
15/05/2007;17;TO;54210000;4024106;50185894
15/06/2007;12;AC;1212228;123101;1089127
15/06/2007;27;AL;19089579;16588652;2500927
15/06/2007;16;AP;4982796;1649045;3333751
15/06/2007;13;AM;85201466;563684994;-478483528
15/06/2007;29;BA;675869524;405403675;270465849
15/06/2007;23;CE;83217181;75838685;7378496
15/06/2007;53;DF;6671408;81091830;-74420422
15/06/2007;32;ES;511283884;522869250;-11585366
15/06/2007;52;GO;301854425;117512162;184342263
15/06/2007;21;MA;134678539;249059871;-114381332
15/06/2007;51;MT;396890632;57125723;339764909
15/06/2007;50;MS;160322578;165287277;-4964699
15/06/2007;31;MG;1431876646;491428789;940447857
15/06/2007;15;PA;627967547;50827464;577140083
15/06/2007;25;PB;16659247;24824450;-8165203
15/06/2007;41;PR;1119397537;612654936;506742601
15/06/2007;26;PE;55279281;128045144;-72765863
15/06/2007;22;PI;4979334;1720786;3258548
15/06/2007;33;RJ;873196340;864265844;8930496
15/06/2007;24;RN;21600330;13919152;7681178
15/06/2007;43;RS;1278985852;633277504;645708348
15/06/2007;11;RO;35339148;4624560;30714588
15/06/2007;14;RR;787389;163286;624103
15/06/2007;42;SC;623299590;361082443;262217147
15/06/2007;35;SP;4405586319;3826907585;578678734
15/06/2007;28;SE;11479343;6292682;5186661
15/06/2007;17;TO;21291055;8579844;12711211
15/07/2007;12;AC;1358594;42939;1315655
15/07/2007;27;AL;11838846;8081604;3757242
15/07/2007;16;AP;14325752;4535071;9790681
15/07/2007;13;AM;104543176;605021968;-500478792
15/07/2007;29;BA;580653774;537361956;43291818
15/07/2007;23;CE;99071642;127956696;-28885054
15/07/2007;53;DF;6908542;91783672;-84875130
15/07/2007;32;ES;654365122;549671051;104694071
15/07/2007;52;GO;267914113;159309157;108604956
15/07/2007;21;MA;234384147;260981950;-26597803
15/07/2007;51;MT;417215330;58970778;358244552
15/07/2007;50;MS;105191555;170890090;-65698535
15/07/2007;31;MG;1710682355;619594110;1091088245
15/07/2007;15;PA;706235610;64298853;641936757
15/07/2007;25;PB;17904054;22528958;-4624904
15/07/2007;41;PR;1135676563;1057650238;78026325
15/07/2007;26;PE;71761816;189306261;-117544445
15/07/2007;22;PI;3905455;3348062;557393
15/07/2007;33;RJ;1187910866;1068964847;118946019
15/07/2007;24;RN;22683598;9193259;13490339
15/07/2007;43;RS;1670955733;698619463;972336270
15/07/2007;11;RO;28140476;5627262;22513214
15/07/2007;14;RR;399429;121242;278187
15/07/2007;42;SC;656576052;422310500;234265552
15/07/2007;35;SP;4198093501;4016720205;181373296
15/07/2007;28;SE;12100849;5582319;6518530
15/07/2007;17;TO;16358731;4919956;11438775
15/08/2007;12;AC;1372640;161914;1210726
15/08/2007;27;AL;5552548;12983436;-7430888
15/08/2007;16;AP;8703722;8049031;654691
15/08/2007;13;AM;107140083;694349158;-587209075
15/08/2007;29;BA;677585884;500697918;176887966
15/08/2007;23;CE;116830866;238315366;-121484500
15/08/2007;53;DF;6174826;80646965;-74472139
15/08/2007;32;ES;586958321;571957035;15001286
15/08/2007;52;GO;299776123;163947649;135828474
15/08/2007;21;MA;200480264;200407596;72668
15/08/2007;51;MT;546133712;90938370;455195342
15/08/2007;50;MS;123461224;210162523;-86701299
15/08/2007;31;MG;1724362004;717185887;1007176117
15/08/2007;15;PA;716070947;66689460;649381487
15/08/2007;25;PB;20116142;24224671;-4108529
15/08/2007;41;PR;1176149038;737377001;438772037
15/08/2007;26;PE;61934851;161943623;-100008772
15/08/2007;22;PI;3713258;7109014;-3395756
15/08/2007;33;RJ;1336314187;1053978498;282335689
15/08/2007;24;RN;27457097;13184156;14272941
15/08/2007;43;RS;1555589257;754884059;800705198
15/08/2007;11;RO;37087303;5888399;31198904
15/08/2007;14;RR;734029;168430;565599
15/08/2007;42;SC;734912237;479467878;255444359
15/08/2007;35;SP;4781300887;4736576605;44724282
15/08/2007;28;SE;15894156;12434973;3459183
15/08/2007;17;TO;11280581;6455598;4824983
15/09/2007;12;AC;1316057;79162;1236895
15/09/2007;27;AL;7696500;36063109;-28366609
15/09/2007;16;AP;8515622;8252671;262951
15/09/2007;13;AM;102852540;613273493;-510420953
15/09/2007;29;BA;597356525;609473491;-12116966
15/09/2007;23;CE;97224462;169385429;-72160967
15/09/2007;53;DF;6326057;81516177;-75190120
15/09/2007;32;ES;553699904;608248974;-54549070
15/09/2007;52;GO;274176051;187094470;87081581
15/09/2007;21;MA;177680009;224908051;-47228042
15/09/2007;51;MT;478291036;54674044;423616992
15/09/2007;50;MS;133924990;215940617;-82015627
15/09/2007;31;MG;1464074439;492646329;971428110
15/09/2007;15;PA;662728281;55116223;607612058
15/09/2007;25;PB;15841428;28184530;-12343102
15/09/2007;41;PR;1060275391;869209898;191065493
15/09/2007;26;PE;79291452;125901629;-46610177
15/09/2007;22;PI;4040880;5338971;-1298091
15/09/2007;33;RJ;1099210628;1039267437;59943191
15/09/2007;24;RN;31960316;15598311;16362005
15/09/2007;43;RS;1265047278;631633333;633413945
15/09/2007;11;RO;45424226;5620184;39804042
15/09/2007;14;RR;566261;108638;457623
15/09/2007;42;SC;630026022;420770507;209255515
15/09/2007;35;SP;4604639052;4180366341;424272711
15/09/2007;28;SE;10437935;15034323;-4596388
15/09/2007;17;TO;9028268;5961106;3067162
15/10/2007;12;AC;1994994;27697;1967297
15/10/2007;27;AL;69304076;22837759;46466317
15/10/2007;16;AP;10728688;6206527;4522161
15/10/2007;13;AM;125401429;756412801;-631011372
15/10/2007;29;BA;683134082;370962665;312171417
15/10/2007;23;CE;112049550;198417773;-86368223
15/10/2007;53;DF;5629735;129722587;-124092852
15/10/2007;32;ES;723349655;654143548;69206107
15/10/2007;52;GO;400865550;208312809;192552741
15/10/2007;21;MA;174278086;113804008;60474078
15/10/2007;51;MT;547325259;71994073;475331186
15/10/2007;50;MS;134268979;233742858;-99473879
15/10/2007;31;MG;1791841071;642558200;1149282871
15/10/2007;15;PA;755413475;65335632;690077843
15/10/2007;25;PB;22891137;33125343;-10234206
15/10/2007;41;PR;1237390507;979942733;257447774
15/10/2007;26;PE;120658266;183623796;-62965530
15/10/2007;22;PI;5560992;2955701;2605291
15/10/2007;33;RJ;1418119678;1494121988;-76002310
15/10/2007;24;RN;51610787;13908166;37702621
15/10/2007;43;RS;1605051150;693601209;911449941
15/10/2007;11;RO;52549254;7257872;45291382
15/10/2007;14;RR;813413;119247;694166
15/10/2007;42;SC;718013301;505017198;212996103
15/10/2007;35;SP;4687472047;4943150703;-255678656
15/10/2007;28;SE;6850977;9544650;-2693673
15/10/2007;17;TO;3837636;7672226;-3834590
15/11/2007;12;AC;1361185;12039;1349146
15/11/2007;27;AL;38104033;58904666;-20800633
15/11/2007;16;AP;10340503;2490076;7850427
15/11/2007;13;AM;96398917;643308290;-546909373
15/11/2007;29;BA;871508999;416083680;455425319
15/11/2007;23;CE;99859750;182875040;-83015290
15/11/2007;53;DF;9913964;78533496;-68619532
15/11/2007;32;ES;503458507;639188956;-135730449
15/11/2007;52;GO;238018153;195185974;42832179
15/11/2007;21;MA;184517710;301420395;-116902685
15/11/2007;51;MT;454793383;70880943;383912440
15/11/2007;50;MS;84913558;255866384;-170952826
15/11/2007;31;MG;1627529777;611930301;1015599476
15/11/2007;15;PA;677873146;67821220;610051926
15/11/2007;25;PB;25383368;26633731;-1250363
15/11/2007;41;PR;1087677135;843954976;243722159
15/11/2007;26;PE;99743247;150090048;-50346801
15/11/2007;22;PI;6149282;3027045;3122237
15/11/2007;33;RJ;1060633355;1177466506;-116833151
15/11/2007;24;RN;43302550;12310519;30992031
15/11/2007;43;RS;1152412882;864905073;287507809
15/11/2007;11;RO;63162122;7147157;56014965
15/11/2007;14;RR;1860821;73644;1787177
15/11/2007;42;SC;646548520;494329122;152219398
15/11/2007;35;SP;4669306615;4917015781;-247709166
15/11/2007;28;SE;9194685;10301739;-1107054
15/11/2007;17;TO;7256044;10031179;-2775135
15/12/2007;12;AC;1777426;18799;1758627
15/12/2007;27;AL;50564783;12372590;38192193
15/12/2007;16;AP;15475048;13819391;1655657
15/12/2007;13;AM;98758642;466667675;-367909033
15/12/2007;29;BA;617387938;447007271;170380667
15/12/2007;23;CE;100226643;77369146;22857497
15/12/2007;53;DF;7628680;97615275;-89986595
15/12/2007;32;ES;626007474;614360966;11646508
15/12/2007;52;GO;273514834;150359794;123155040
15/12/2007;21;MA;146667162;289882692;-143215530
15/12/2007;51;MT;388569335;78559669;310009666
15/12/2007;50;MS;64206232;246945543;-182739311
15/12/2007;31;MG;1520110438;537082137;983028301
15/12/2007;15;PA;770394070;64003862;706390208
15/12/2007;25;PB;23294706;25571836;-2277130
15/12/2007;41;PR;969842043;929401482;40440561
15/12/2007;26;PE;62062940;181340065;-119277125
15/12/2007;22;PI;5421959;4667208;754751
15/12/2007;33;RJ;1723689724;1039653277;684036447
15/12/2007;24;RN;35808191;16894565;18913626
15/12/2007;43;RS;1272276543;769682079;502594464
15/12/2007;11;RO;34840234;8198158;26642076
15/12/2007;14;RR;4343060;144325;4198735
15/12/2007;42;SC;640358115;493362011;146996104
15/12/2007;35;SP;4462307263;4020608153;441699110
15/12/2007;28;SE;11260586;7944819;3315767
15/12/2007;17;TO;4817062;10203767;-5386705
15/01/2008;12;AC;1947185;4021;1943164
15/01/2008;27;AL;97628264;18841831;78786433
15/01/2008;16;AP;18676156;1720600;16955556
15/01/2008;13;AM;86629298;766842752;-680213454
15/01/2008;29;BA;733711290;510868121;222843169
15/01/2008;23;CE;110335062;126743029;-16407967
15/01/2008;53;DF;11046040;70362748;-59316708
15/01/2008;32;ES;612486386;606375842;6110544
15/01/2008;52;GO;230359809;202007577;28352232
15/01/2008;21;MA;161304137;95467752;65836385
15/01/2008;51;MT;439549992;56507832;383042160
15/01/2008;50;MS;84939320;270963979;-186024659
15/01/2008;31;MG;1646383446;678852849;967530597
15/01/2008;15;PA;783808615;68462577;715346038
15/01/2008;25;PB;18990488;33818483;-14827995
15/01/2008;41;PR;1015477179;805088035;210389144
15/01/2008;26;PE;93852206;211030947;-117178741
15/01/2008;22;PI;4629873;8695933;-4066060
15/01/2008;33;RJ;1152888090;1460283100;-307395010
15/01/2008;24;RN;43538178;19747879;23790299
15/01/2008;43;RS;1148813919;795108365;353705554
15/01/2008;11;RO;41275064;7589781;33685283
15/01/2008;14;RR;2633902;57821;2576081
15/01/2008;42;SC;513266818;637762929;-124496111
15/01/2008;35;SP;3932905437;4870860233;-937954796
15/01/2008;28;SE;18354197;20997264;-2643067
15/01/2008;17;TO;3270659;11537194;-8266535
15/02/2008;12;AC;2240131;31707;2208424
15/02/2008;27;AL;112861819;30086925;82774894
15/02/2008;16;AP;3975161;1358051;2617110
15/02/2008;13;AM;85585654;620186378;-534600724
15/02/2008;29;BA;558794310;647828482;-89034172
15/02/2008;23;CE;100568696;151245761;-50677065
15/02/2008;53;DF;10989443;72526839;-61537396
15/02/2008;32;ES;645993926;570454816;75539110
15/02/2008;52;GO;198625851;158993940;39631911
15/02/2008;21;MA;145750564;253505601;-107755037
15/02/2008;51;MT;267279305;91346189;175933116
15/02/2008;50;MS;112712682;283377041;-170664359
15/02/2008;31;MG;1484683622;643548444;841135178
15/02/2008;15;PA;656538231;67243600;589294631
15/02/2008;25;PB;18399662;30148020;-11748358
15/02/2008;41;PR;969814001;1093993170;-124179169
15/02/2008;26;PE;65660710;203050778;-137390068
15/02/2008;22;PI;5153853;4180770;973083
15/02/2008;33;RJ;959029163;1072311272;-113282109
15/02/2008;24;RN;28625338;11834624;16790714
15/02/2008;43;RS;1191426099;717666967;473759132
15/02/2008;11;RO;45461329;7842774;37618555
15/02/2008;14;RR;447778;277074;170704
15/02/2008;42;SC;629462117;591287797;38174320
15/02/2008;35;SP;4189146438;4621780046;-432633608
15/02/2008;28;SE;8547563;15241271;-6693708
15/02/2008;17;TO;4999349;8618962;-3619613
15/03/2008;12;AC;2011378;84501;1926877
15/03/2008;27;AL;68933647;5187716;63745931
15/03/2008;16;AP;21610464;2836084;18774380
15/03/2008;13;AM;77051420;761578610;-684527190
15/03/2008;29;BA;666125331;551839859;114285472
15/03/2008;23;CE;97580104;87149189;10430915
15/03/2008;53;DF;11341160;67347919;-56006759
15/03/2008;32;ES;378648748;550673734;-172024986
15/03/2008;52;GO;188666985;217119165;-28452180
15/03/2008;21;MA;99110620;533142857;-434032237
15/03/2008;51;MT;574060889;48104447;525956442
15/03/2008;50;MS;122404246;257241997;-134837751
15/03/2008;31;MG;1428715524;552214579;876500945
15/03/2008;15;PA;555046711;50351880;504694831
15/03/2008;25;PB;14654163;31184488;-16530325
15/03/2008;41;PR;1096253883;854747243;241506640
15/03/2008;26;PE;62294298;132368901;-70074603
15/03/2008;22;PI;4632737;4995679;-362942
15/03/2008;33;RJ;757078590;1089788519;-332709929
15/03/2008;24;RN;22568093;13614304;8953789
15/03/2008;43;RS;1152548148;781044369;371503779
15/03/2008;11;RO;60901287;8592433;52308854
15/03/2008;14;RR;1131452;136908;994544
15/03/2008;42;SC;652118101;556538596;95579505
15/03/2008;35;SP;4227166039;4467853126;-240687087
15/03/2008;28;SE;7824747;8580957;-756210
15/03/2008;17;TO;6204020;6094134;109886
15/04/2008;12;AC;2633359;61261;2572098
15/04/2008;27;AL;47319410;10685108;36634302
15/04/2008;16;AP;11371506;6928844;4442662
15/04/2008;13;AM;92861609;816794236;-723932627
15/04/2008;29;BA;650122766;448488519;201634247
15/04/2008;23;CE;94176881;84640438;9536443
15/04/2008;53;DF;8653219;83782590;-75129371
15/04/2008;32;ES;621700751;651643915;-29943164
15/04/2008;52;GO;383408956;220264746;163144210
15/04/2008;21;MA;115696116;311881100;-196184984
15/04/2008;51;MT;807535963;73942050;733593913
15/04/2008;50;MS;191233932;280549038;-89315106
15/04/2008;31;MG;1654285886;822233006;832052880
15/04/2008;15;PA;583386190;83478655;499907535
15/04/2008;25;PB;22478888;18611723;3867165
15/04/2008;41;PR;1184940876;636749954;548190922
15/04/2008;26;PE;66016630;135381275;-69364645
15/04/2008;22;PI;7064246;462589;6601657
15/04/2008;33;RJ;599129291;1186031382;-586902091
15/04/2008;24;RN;20907432;9649536;11257896
15/04/2008;43;RS;1379575537;744759543;634815994
15/04/2008;11;RO;74923536;9770064;65153472
15/04/2008;14;RR;845787;307503;538284
15/04/2008;42;SC;653454812;568164203;85290609
15/04/2008;35;SP;4538480358;5126046253;-587565895
15/04/2008;28;SE;14104578;5439315;8665263
15/04/2008;17;TO;24047378;7115036;16932342
15/05/2008;12;AC;2451985;84884;2367101
15/05/2008;27;AL;148608999;32030971;116578028
15/05/2008;16;AP;31241630;9791014;21450616
15/05/2008;13;AM;107939689;843033888;-735094199
15/05/2008;29;BA;985355126;589743877;395611249
15/05/2008;23;CE;90555427;123886296;-33330869
15/05/2008;53;DF;14818369;73274294;-58455925
15/05/2008;32;ES;999545494;699720868;299824626
15/05/2008;52;GO;436544670;262597001;173947669
15/05/2008;21;MA;276960835;570704593;-293743758
15/05/2008;51;MT;950142543;150793506;799349037
15/05/2008;50;MS;260576435;328131219;-67554784
15/05/2008;31;MG;2007693283;802826465;1204866818
15/05/2008;15;PA;1032922114;57518944;975403170
15/05/2008;25;PB;17583187;31519015;-13935828
15/05/2008;41;PR;1858202996;1843509812;14693184
15/05/2008;26;PE;72598089;196597059;-123998970
15/05/2008;22;PI;5677104;2844766;2832338
15/05/2008;33;RJ;2234033278;1560663650;673369628
15/05/2008;24;RN;26394989;21700740;4694249
15/05/2008;43;RS;1677831365;840299437;837531928
15/05/2008;11;RO;77554421;14329368;63225053
15/05/2008;14;RR;965099;316929;648170
15/05/2008;42;SC;866401509;687831895;178569614
15/05/2008;35;SP;4737229079;5464625049;-727395970
15/05/2008;28;SE;7361763;21578466;-14216703
15/05/2008;17;TO;72093017;10452162;61640855
15/06/2008;12;AC;1727205;169921;1557284
15/06/2008;27;AL;80486264;21132271;59353993
15/06/2008;16;AP;10532868;2330159;8202709
15/06/2008;13;AM;126625270;773270703;-646645433
15/06/2008;29;BA;697119542;537232571;159886971
15/06/2008;23;CE;106770557;195862933;-89092376
15/06/2008;53;DF;16984925;109909997;-92925072
15/06/2008;32;ES;877811989;655565262;222246727
15/06/2008;52;GO;369557089;363853042;5704047
15/06/2008;21;MA;188712247;369296059;-180583812
15/06/2008;51;MT;773619142;227903230;545715912
15/06/2008;50;MS;209767109;326487508;-116720399
15/06/2008;31;MG;2319417133;869061019;1450356114
15/06/2008;15;PA;867418269;106482383;760935886
15/06/2008;25;PB;14998088;32486666;-17488578
15/06/2008;41;PR;1484379057;1384527575;99851482
15/06/2008;26;PE;56721633;230986042;-174264409
15/06/2008;22;PI;18523678;5971739;12551939
15/06/2008;33;RJ;2022904464;2005786630;17117834
15/06/2008;24;RN;22370890;31718369;-9347479
15/06/2008;43;RS;1669158971;980391974;688766997
15/06/2008;11;RO;45724623;14260978;31463645
15/06/2008;14;RR;1121450;168334;953116
15/06/2008;42;SC;799251576;705384560;93867016
15/06/2008;35;SP;5510941651;5895662275;-384720624
15/06/2008;28;SE;9109176;26144871;-17035695
15/06/2008;17;TO;36876273;10373128;26503145
15/07/2008;12;AC;2171019;53456;2117563
15/07/2008;27;AL;34757863;22114461;12643402
15/07/2008;16;AP;10211040;2842382;7368658
15/07/2008;13;AM;110272209;1074452363;-964180154
15/07/2008;29;BA;1021864602;610496588;411368014
15/07/2008;23;CE;119341552;179564903;-60223351
15/07/2008;53;DF;20225890;105043447;-84817557
15/07/2008;32;ES;1075667858;747184688;328483170
15/07/2008;52;GO;642221714;319653362;322568352
15/07/2008;21;MA;312662270;354393493;-41731223
15/07/2008;51;MT;912781747;139299390;773482357
15/07/2008;50;MS;256876196;325754062;-68877866
15/07/2008;31;MG;2650331053;1065983588;1584347465
15/07/2008;15;PA;1051252410;82045021;969207389
15/07/2008;25;PB;19359158;36083324;-16724166
15/07/2008;41;PR;1799736078;1674657632;125078446
15/07/2008;26;PE;60238506;253689737;-193451231
15/07/2008;22;PI;20405221;9147183;11258038
15/07/2008;33;RJ;1736880055;1682431278;54448777
15/07/2008;24;RN;20613006;21231977;-618971
15/07/2008;43;RS;1840344354;989283366;851060988
15/07/2008;11;RO;62177935;15417540;46760395
15/07/2008;14;RR;930753;281619;649134
15/07/2008;42;SC;831557277;748522579;83034698
15/07/2008;35;SP;5467012234;6649668376;-1182656142
15/07/2008;28;SE;10876635;18249906;-7373271
15/07/2008;17;TO;33817110;19317352;14499758
15/08/2008;12;AC;1270838;53667;1217171
15/08/2008;27;AL;29049999;29119642;-69643
15/08/2008;16;AP;27041115;2046077;24995038
15/08/2008;13;AM;116954599;963073232;-846118633
15/08/2008;29;BA;746824429;482123055;264701374
15/08/2008;23;CE;113039158;95688489;17350669
15/08/2008;53;DF;19427004;96761200;-77334196
15/08/2008;32;ES;1081513022;808235738;273277284
15/08/2008;52;GO;498726782;332184009;166542773
15/08/2008;21;MA;353218744;561037327;-207818583
15/08/2008;51;MT;694282980;114290641;579992339
15/08/2008;50;MS;213780955;391165279;-177384324
15/08/2008;31;MG;2570425568;1044004755;1526420813
15/08/2008;15;PA;1283692670;91694233;1191998437
15/08/2008;25;PB;15375016;30784770;-15409754
15/08/2008;41;PR;1364200697;1369515472;-5314775
15/08/2008;26;PE;76748804;270797605;-194048801
15/08/2008;22;PI;12989977;8188115;4801862
15/08/2008;33;RJ;2311320542;1906697192;404623350
15/08/2008;24;RN;24704186;23375668;1328518
15/08/2008;43;RS;1722317306;1392430160;329887146
15/08/2008;11;RO;35784715;12641227;23143488
15/08/2008;14;RR;994272;137483;856789
15/08/2008;42;SC;794333106;800604802;-6271696
15/08/2008;35;SP;5333078858;6604701214;-1271622356
15/08/2008;28;SE;12897461;16772967;-3875506
15/08/2008;17;TO;25897818;12657385;13240433
15/09/2008;12;AC;1616705;10932;1605773
15/09/2008;27;AL;15241614;18714784;-3473170
15/09/2008;16;AP;10839032;3281405;7557627
15/09/2008;13;AM;129917212;1128626059;-998708847
15/09/2008;29;BA;817873356;522411524;295461832
15/09/2008;23;CE;131395964;122710390;8685574
15/09/2008;53;DF;20914400;124872136;-103957736
15/09/2008;32;ES;1202884251;720012642;482871609
15/09/2008;52;GO;350630136;294406110;56224026
15/09/2008;21;MA;337861148;378056896;-40195748
15/09/2008;51;MT;711870586;120999842;590870744
15/09/2008;50;MS;227692038;377501594;-149809556
15/09/2008;31;MG;2820810925;1204544923;1616266002
15/09/2008;15;PA;1092609128;87348950;1005260178
15/09/2008;25;PB;18893217;39973623;-21080406
15/09/2008;41;PR;1351731108;1361168666;-9437558
15/09/2008;26;PE;69046393;272874580;-203828187
15/09/2008;22;PI;7351859;6674878;676981
15/09/2008;33;RJ;1431414000;1778601189;-347187189
15/09/2008;24;RN;29278805;15738789;13540016
15/09/2008;43;RS;1689671890;1082473928;607197962
15/09/2008;11;RO;47010643;15860005;31150638
15/09/2008;14;RR;641351;206781;434570
15/09/2008;42;SC;767475782;814266660;-46790878
15/09/2008;35;SP;5514795192;6729586134;-1214790942
15/09/2008;28;SE;7171930;27508956;-20337026
15/09/2008;17;TO;34148246;22299032;11849214
15/10/2008;12;AC;1729697;515933;1213764
15/10/2008;27;AL;47306805;12993944;34312861
15/10/2008;16;AP;19912390;4733316;15179074
15/10/2008;13;AM;139228336;1115386438;-976158102
15/10/2008;29;BA;727908180;601755788;126152392
15/10/2008;23;CE;103001883;102128557;873326
15/10/2008;53;DF;7317940;70305466;-62987526
15/10/2008;32;ES;1089436699;796147843;293288856
15/10/2008;52;GO;355588793;270701992;84886801
15/10/2008;21;MA;340607751;390152486;-49544735
15/10/2008;51;MT;660225567;154806782;505418785
15/10/2008;50;MS;192579900;339812847;-147232947
15/10/2008;31;MG;2578462630;1101634697;1476827933
15/10/2008;15;PA;1143309567;96444566;1046865001
15/10/2008;25;PB;20904839;35984527;-15079688
15/10/2008;41;PR;1207249749;1583681841;-376432092
15/10/2008;26;PE;127180247;233071922;-105891675
15/10/2008;22;PI;9692210;16543154;-6850944
15/10/2008;33;RJ;1864080481;1670568469;193512012
15/10/2008;24;RN;35855102;14047905;21807197
15/10/2008;43;RS;1656111847;1098583229;557528618
15/10/2008;11;RO;30890824;15597305;15293519
15/10/2008;14;RR;981373;236310;745063
15/10/2008;42;SC;742330915;730938547;11392368
15/10/2008;35;SP;4972062951;6710284174;-1738221223
15/10/2008;28;SE;6502907;14535266;-8032359
15/10/2008;17;TO;27619745;13873229;13746516
15/11/2008;12;AC;688718;13255;675463
15/11/2008;27;AL;87557487;12420077;75137410
15/11/2008;16;AP;7239262;4453224;2786038
15/11/2008;13;AM;102504965;717935978;-615431013
15/11/2008;29;BA;610215952;423478607;186737345
15/11/2008;23;CE;100787919;145360863;-44572944
15/11/2008;53;DF;6771095;76511731;-69740636
15/11/2008;32;ES;846885299;731470968;115414331
15/11/2008;52;GO;191628745;212887833;-21259088
15/11/2008;21;MA;290545734;137381091;153164643
15/11/2008;51;MT;514867191;58357935;456509256
15/11/2008;50;MS;130962333;57715427;73246906
15/11/2008;31;MG;1786351614;974388069;811963545
15/11/2008;15;PA;823765654;105497585;718268069
15/11/2008;25;PB;24538428;37329701;-12791273
15/11/2008;41;PR;865423911;976833730;-111409819
15/11/2008;26;PE;110812675;173045816;-62233141
15/11/2008;22;PI;12855878;1974367;10881511
15/11/2008;33;RJ;1490649599;1275145711;215503888
15/11/2008;24;RN;34543183;15760002;18783181
15/11/2008;43;RS;1114229986;791336060;322893926
15/11/2008;11;RO;30385712;17519588;12866124
15/11/2008;14;RR;2461035;208575;2252460
15/11/2008;42;SC;478520580;613056565;-134535985
15/11/2008;35;SP;4162708095;5523879917;-1361171822
15/11/2008;28;SE;4846488;9239689;-4393201
15/11/2008;17;TO;15100436;11401502;3698934
15/12/2008;12;AC;1463443;57083;1406360
15/12/2008;27;AL;106802042;6664063;100137979
15/12/2008;16;AP;19789408;2135700;17653708
15/12/2008;13;AM;82539082;536265888;-453726806
15/12/2008;29;BA;472618114;328725517;143892597
15/12/2008;23;CE;106834092;147964066;-41129974
15/12/2008;53;DF;16646797;131778039;-115131242
15/12/2008;32;ES;525958747;652078749;-126120002
15/12/2008;52;GO;235723754;186383863;49339891
15/12/2008;21;MA;213545606;147301430;66244176
15/12/2008;51;MT;501478924;41796896;459682028
15/12/2008;50;MS;87951667;626596082;-538644415
15/12/2008;31;MG;1435076612;695932068;739144544
15/12/2008;15;PA;796159920;115333378;680826542
15/12/2008;25;PB;20685065;37438942;-16753877
15/12/2008;41;PR;967612698;1036637579;-69024881
15/12/2008;26;PE;73626431;160677930;-87051499
15/12/2008;22;PI;27922033;2006957;25915076
15/12/2008;33;RJ;1286238480;1240459295;45779185
15/12/2008;24;RN;37716265;9086449;28629816
15/12/2008;43;RS;1202420638;538843546;663577092
15/12/2008;11;RO;27521076;21808724;5712352
15/12/2008;14;RR;2451631;114785;2336846
15/12/2008;42;SC;562950297;510358684;52591613
15/12/2008;35;SP;4620828074;4309164642;311663432
15/12/2008;28;SE;4009512;7811398;-3801886
15/12/2008;17;TO;13609962;9084820;4525142
15/01/2009;12;AC;684376;46471;637905
15/01/2009;27;AL;111331409;7979919;103351490
15/01/2009;16;AP;18522836;1718684;16804152
15/01/2009;13;AM;55515850;501599068;-446083218
15/01/2009;29;BA;389665485;216589384;173076101
15/01/2009;23;CE;83790554;81608248;2182306
15/01/2009;53;DF;7535300;60632970;-53097670
15/01/2009;32;ES;376373245;629405463;-253032218
15/01/2009;52;GO;196606909;158637589;37969320
15/01/2009;21;MA;156542866;94952507;61590359
15/01/2009;51;MT;542606190;48415170;494191020
15/01/2009;50;MS;85509954;298046987;-212537033
15/01/2009;31;MG;1419792293;564276975;855515318
15/01/2009;15;PA;578110529;86316143;491794386
15/01/2009;25;PB;14368368;35185810;-20817442
15/01/2009;41;PR;742480410;582080242;160400168
15/01/2009;26;PE;83613343;125362553;-41749210
15/01/2009;22;PI;5736024;1692058;4043966
15/01/2009;33;RJ;651671214;1173746512;-522075298
15/01/2009;24;RN;23852631;9701846;14150785
15/01/2009;43;RS;702357047;515384556;186972491
15/01/2009;11;RO;16378724;13109982;3268742
15/01/2009;14;RR;3170764;188216;2982548
15/01/2009;42;SC;438694889;592411256;-153716367
15/01/2009;35;SP;2727176125;4477311563;-1750135438
15/01/2009;28;SE;3013521;25308657;-22295136
15/01/2009;17;TO;1616701;6309843;-4693142
15/02/2009;12;AC;1067879;57892;1009987
15/02/2009;27;AL;69613435;3459156;66154279
15/02/2009;16;AP;22816413;2536956;20279457
15/02/2009;13;AM;63539558;407552968;-344013410
15/02/2009;29;BA;442378524;215747170;226631354
15/02/2009;23;CE;82431672;56272582;26159090
15/02/2009;53;DF;4680143;65371511;-60691368
15/02/2009;32;ES;355823527;388333869;-32510342
15/02/2009;52;GO;163046370;160276285;2770085
15/02/2009;21;MA;107658584;26304066;81354518
15/02/2009;51;MT;369040915;28106430;340934485
15/02/2009;50;MS;84413733;59858822;24554911
15/02/2009;31;MG;1333544387;436492231;897052156
15/02/2009;15;PA;631642176;87484713;544157463
15/02/2009;25;PB;12674573;34763575;-22089002
15/02/2009;41;PR;586871186;558250499;28620687
15/02/2009;26;PE;69877943;103224291;-33346348
15/02/2009;22;PI;16548585;1361458;15187127
15/02/2009;33;RJ;740128442;811955078;-71826636
15/02/2009;24;RN;20285536;12747723;7537813
15/02/2009;43;RS;873505952;450914695;422591257
15/02/2009;11;RO;31492987;8681627;22811360
15/02/2009;14;RR;464860;47200;417660
15/02/2009;42;SC;447438377;526252903;-78814526
15/02/2009;35;SP;2773633803;3358476314;-584842511
15/02/2009;28;SE;5405457;10136546;-4731089
15/02/2009;17;TO;3181077;8470677;-5289600
15/03/2009;12;AC;966865;132081;834784
15/03/2009;27;AL;94075727;10062698;84013029
15/03/2009;16;AP;19444978;1364269;18080709
15/03/2009;13;AM;76664347;494555761;-417891414
15/03/2009;29;BA;467533312;392912590;74620722
15/03/2009;23;CE;73031396;129344968;-56313572
15/03/2009;53;DF;10356917;115663820;-105306903
15/03/2009;32;ES;433154263;574604936;-141450673
15/03/2009;52;GO;262065517;270646558;-8581041
15/03/2009;21;MA;122638294;131114319;-8476025
15/03/2009;51;MT;902552978;9650026;892902952
15/03/2009;50;MS;126651434;344946833;-218295399
15/03/2009;31;MG;1562843513;478159246;1084684267
15/03/2009;15;PA;792359211;109631991;682727220
15/03/2009;25;PB;11142654;45256635;-34113981
15/03/2009;41;PR;848190479;674864466;173326013
15/03/2009;26;PE;42264959;155617845;-113352886
15/03/2009;22;PI;18935910;6987715;11948195
15/03/2009;33;RJ;574375458;955769018;-381393560
15/03/2009;24;RN;28850739;7631600;21219139
15/03/2009;43;RS;881227865;482719282;398508583
15/03/2009;11;RO;23814075;13290146;10523929
15/03/2009;14;RR;699481;182870;516611
15/03/2009;42;SC;527641618;528679714;-1038096
15/03/2009;35;SP;3433708363;4108453595;-674745232
15/03/2009;28;SE;7236525;5661377;1575148
15/03/2009;17;TO;5941291;9017307;-3076016
15/04/2009;12;AC;1193224;257515;935709
15/04/2009;27;AL;57324755;15723327;41601428
15/04/2009;16;AP;7432004;2326565;5105439
15/04/2009;13;AM;59169835;520535736;-461365901
15/04/2009;29;BA;475570938;308070093;167500845
15/04/2009;23;CE;100393043;145465941;-45072898
15/04/2009;53;DF;10677771;87592252;-76914481
15/04/2009;32;ES;555318989;380991537;174327452
15/04/2009;52;GO;330343997;130985818;199358179
15/04/2009;21;MA;66710904;82505891;-15794987
15/04/2009;51;MT;888201685;44259997;843941688
15/04/2009;50;MS;168194305;200621823;-32427518
15/04/2009;31;MG;1724511052;487082465;1237428587
15/04/2009;15;PA;748523626;92516267;656007359
15/04/2009;25;PB;12136405;26412393;-14275988
15/04/2009;41;PR;1111426973;607221801;504205172
15/04/2009;26;PE;56429504;112308758;-55879254
15/04/2009;22;PI;4306999;4347045;-40046
15/04/2009;33;RJ;785654378;960793093;-175138715
15/04/2009;24;RN;14333805;16201158;-1867353
15/04/2009;43;RS;1054212333;556874986;497337347
15/04/2009;11;RO;48739057;15794971;32944086
15/04/2009;14;RR;836671;384045;452626
15/04/2009;42;SC;527989167;427558874;100430293
15/04/2009;35;SP;3158520784;3380160502;-221639718
15/04/2009;28;SE;5099809;9751462;-4651653
15/04/2009;17;TO;34684323;11812336;22871987
15/05/2009;12;AC;1166293;39365;1126928
15/05/2009;27;AL;80543436;9160297;71383139
15/05/2009;16;AP;15982278;1550382;14431896
15/05/2009;13;AM;61830467;444903285;-383072818
15/05/2009;29;BA;455898915;404194429;51704486
15/05/2009;23;CE;71017961;97807683;-26789722
15/05/2009;53;DF;8900032;92184141;-83284109
15/05/2009;32;ES;373958597;375445682;-1487085
15/05/2009;52;GO;340806329;197638675;143167654
15/05/2009;21;MA;84625785;149331588;-64705803
15/05/2009;51;MT;869656842;103721077;765935765
15/05/2009;50;MS;181118862;359169712;-178050850
15/05/2009;31;MG;1320496158;548702707;771793451
15/05/2009;15;PA;480020467;55778269;424242198
15/05/2009;25;PB;14153528;30815144;-16661616
15/05/2009;41;PR;1112907451;681329574;431577877
15/05/2009;26;PE;50546004;139899684;-89353680
15/05/2009;22;PI;4741687;8933352;-4191665
15/05/2009;33;RJ;936549212;987651644;-51102432
15/05/2009;24;RN;18254333;9074892;9179441
15/05/2009;43;RS;1300264466;620976992;679287474
15/05/2009;11;RO;52406452;12317890;40088562
15/05/2009;14;RR;913259;5187232;-4273973
15/05/2009;42;SC;604594937;478149573;126445364
15/05/2009;35;SP;3208003468;3520677692;-312674224
15/05/2009;28;SE;4568227;12325489;-7757262
15/05/2009;17;TO;49143717;20911742;28231975
15/06/2009;12;AC;1505489;1599;1503890
15/06/2009;27;AL;69831419;7404352;62427067
15/06/2009;16;AP;9255305;1202156;8053149
15/06/2009;13;AM;58266696;506342954;-448076258
15/06/2009;29;BA;566644905;382700252;183944653
15/06/2009;23;CE;82209537;92473972;-10264435
15/06/2009;53;DF;8430520;92463548;-84033028
15/06/2009;32;ES;420154973;327814820;92340153
15/06/2009;52;GO;481268509;230389892;250878617
15/06/2009;21;MA;85043470;138410820;-53367350
15/06/2009;51;MT;1027276951;124716322;902560629
15/06/2009;50;MS;246291658;220131143;26160515
15/06/2009;31;MG;1626619521;620988615;1005630906
15/06/2009;15;PA;737552607;47850237;689702370
15/06/2009;25;PB;11802302;39273861;-27471559
15/06/2009;41;PR;1324001821;753871432;570130389
15/06/2009;26;PE;54488472;128227573;-73739101
15/06/2009;22;PI;22059134;4428395;17630739
15/06/2009;33;RJ;890659731;1049676261;-159016530
15/06/2009;24;RN;18495351;14872594;3622757
15/06/2009;43;RS;1876290648;530251221;1346039427
15/06/2009;11;RO;30779245;13840733;16938512
15/06/2009;14;RR;870179;516513;353666
15/06/2009;42;SC;617185684;503298203;113887481
15/06/2009;35;SP;3776488526;4025713107;-249224581
15/06/2009;28;SE;4382307;13158125;-8775818
15/06/2009;17;TO;59318329;4736690;54581639
15/07/2009;12;AC;1164684;142169;1022515
15/07/2009;27;AL;10273045;9484913;788132
15/07/2009;16;AP;10701072;5387303;5313769
15/07/2009;13;AM;73906413;605527314;-531620901
15/07/2009;29;BA;738473780;411735074;326738706
15/07/2009;23;CE;95172091;122201648;-27029557
15/07/2009;53;DF;14737165;106447400;-91710235
15/07/2009;32;ES;569358237;378966350;190391887
15/07/2009;52;GO;326490669;260471814;66018855
15/07/2009;21;MA;128698355;263088056;-134389701
15/07/2009;51;MT;898500989;140689777;757811212
15/07/2009;50;MS;160293745;221090409;-60796664
15/07/2009;31;MG;1578632221;689644875;888987346
15/07/2009;15;PA;714539222;60374943;654164279
15/07/2009;25;PB;14938041;28146717;-13208676
15/07/2009;41;PR;1025358304;960696116;64662188
15/07/2009;26;PE;42323294;179005831;-136682537
15/07/2009;22;PI;25086393;2929580;22156813
15/07/2009;33;RJ;1645401739;1211695420;433706319
15/07/2009;24;RN;16764499;12502791;4261708
15/07/2009;43;RS;1503356743;686200254;817156489
15/07/2009;11;RO;40567684;17843854;22723830
15/07/2009;14;RR;1655865;685143;970722
15/07/2009;42;SC;552121479;588876004;-36754525
15/07/2009;35;SP;3569331871;4260685025;-691353154
15/07/2009;28;SE;6430835;10255528;-3824693
15/07/2009;17;TO;55329139;9053734;46275405
15/08/2009;12;AC;1626611;209109;1417502
15/08/2009;27;AL;7474643;6082424;1392219
15/08/2009;16;AP;14052271;2557680;11494591
15/08/2009;13;AM;66313095;628524154;-562211059
15/08/2009;29;BA;698813567;476173561;222640006
15/08/2009;23;CE;81011806;119003612;-37991806
15/08/2009;53;DF;15976624;65896709;-49920085
15/08/2009;32;ES;573935940;396308201;177627739
15/08/2009;52;GO;381826880;269172520;112654360
15/08/2009;21;MA;106221724;189566842;-83345118
15/08/2009;51;MT;803941104;66221829;737719275
15/08/2009;50;MS;214807774;223285974;-8478200
15/08/2009;31;MG;1645852681;704328279;941524402
15/08/2009;15;PA;606715561;56750670;549964891
15/08/2009;25;PB;14648494;46863367;-32214873
15/08/2009;41;PR;1097626764;784585948;313040816
15/08/2009;26;PE;49741999;163821590;-114079591
15/08/2009;22;PI;13323023;9611947;3711076
15/08/2009;33;RJ;1628709208;978188542;650520666
15/08/2009;24;RN;15746768;20702135;-4955367
15/08/2009;43;RS;1421455934;672974483;748481451
15/08/2009;11;RO;24241658;12893282;11348376
15/08/2009;14;RR;1052847;518050;534797
15/08/2009;42;SC;515000730;596244429;-81243699
15/08/2009;35;SP;3499184795;4280767315;-781582520
15/08/2009;28;SE;4460713;14753741;-10293028
15/08/2009;17;TO;27525291;11887738;15637553
15/09/2009;12;AC;1637610;73796;1563814
15/09/2009;27;AL;22322397;11897690;10424707
15/09/2009;16;AP;20924468;2540841;18383627
15/09/2009;13;AM;75902563;744352821;-668450258
15/09/2009;29;BA;725522371;501077277;224445094
15/09/2009;23;CE;93268037;86880331;6387706
15/09/2009;53;DF;15895843;98616011;-82720168
15/09/2009;32;ES;649968771;440116941;209851830
15/09/2009;52;GO;310054578;263901052;46153526
15/09/2009;21;MA;111142161;300751205;-189609044
15/09/2009;51;MT;558601993;65573870;493028123
15/09/2009;50;MS;167052177;208033391;-40981214
15/09/2009;31;MG;1866512876;756088796;1110424080
15/09/2009;15;PA;780763736;51310849;729452887
15/09/2009;25;PB;15836141;31987085;-16150944
15/09/2009;41;PR;907078497;1076773896;-169695399
15/09/2009;26;PE;59493243;221653723;-162160480
15/09/2009;22;PI;10754700;4266598;6488102
15/09/2009;33;RJ;1154119346;1360877692;-206758346
15/09/2009;24;RN;19292817;17878231;1414586
15/09/2009;43;RS;1402274786;680587026;721687760
15/09/2009;11;RO;25156731;16084697;9072034
15/09/2009;14;RR;965605;1141695;-176090
15/09/2009;42;SC;501298431;674359677;-173061246
15/09/2009;35;SP;4038348732;4930532550;-892183818
15/09/2009;28;SE;4344817;7519061;-3174244
15/09/2009;17;TO;16570037;7902407;8667630
15/10/2009;12;AC;1400081;99792;1300289
15/10/2009;27;AL;50945966;8669112;42276854
15/10/2009;16;AP;11200748;12816762;-1616014
15/10/2009;13;AM;87158732;852829029;-765670297
15/10/2009;29;BA;773137617;499775422;273362195
15/10/2009;23;CE;106803549;77851877;28951672
15/10/2009;53;DF;13581997;113253126;-99671129
15/10/2009;32;ES;571676358;486166918;85509440
15/10/2009;52;GO;282251729;316752553;-34500824
15/10/2009;21;MA;116983528;216490871;-99507343
15/10/2009;51;MT;593158929;61627391;531531538
15/10/2009;50;MS;173556108;200484897;-26928789
15/10/2009;31;MG;1873479454;744868746;1128610708
15/10/2009;15;PA;833328099;45499236;787828863
15/10/2009;25;PB;10478132;44494314;-34016182
15/10/2009;41;PR;842350362;1059638301;-217287939
15/10/2009;26;PE;107764357;222022410;-114258053
15/10/2009;22;PI;8647494;7025286;1622208
15/10/2009;33;RJ;1490945259;1259739123;231206136
15/10/2009;24;RN;26454640;8979116;17475524
15/10/2009;43;RS;1429614574;712122693;717491881
15/10/2009;11;RO;26575735;17668780;8906955
15/10/2009;14;RR;764350;347168;417182
15/10/2009;42;SC;552809894;722247284;-169437390
15/10/2009;35;SP;3770802978;5059063485;-1288260507
15/10/2009;28;SE;4320540;12374207;-8053667
15/10/2009;17;TO;8052121;14381417;-6329296
15/11/2009;12;AC;1839065;276380;1562685
15/11/2009;27;AL;83380329;11966885;71413444
15/11/2009;16;AP;10560247;3212258;7347989
15/11/2009;13;AM;103066200;747614280;-644548080
15/11/2009;29;BA;578238927;408218848;170020079
15/11/2009;23;CE;101171952;111918888;-10746936
15/11/2009;53;DF;7120803;101773045;-94652242
15/11/2009;32;ES;531122859;453779450;77343409
15/11/2009;52;GO;252612777;266424183;-13811406
15/11/2009;21;MA;86237407;205787434;-119550027
15/11/2009;51;MT;422484127;57537178;364946949
15/11/2009;50;MS;134237569;227901848;-93664279
15/11/2009;31;MG;1743665557;722859672;1020805885
15/11/2009;15;PA;618436845;36363349;582073496
15/11/2009;25;PB;9469850;39827556;-30357706
15/11/2009;41;PR;735418922;1016020776;-280601854
15/11/2009;26;PE;102024205;227058638;-125034433
15/11/2009;22;PI;29895603;4830247;25065356
15/11/2009;33;RJ;1384563092;1258487083;126076009
15/11/2009;24;RN;30919866;6896978;24022888
15/11/2009;43;RS;928660986;686527983;242133003
15/11/2009;11;RO;32555203;12759680;19795523
15/11/2009;14;RR;733097;294686;438411
15/11/2009;42;SC;537035571;736480446;-199444875
15/11/2009;35;SP;3723109313;4690897484;-967788171
15/11/2009;28;SE;5782663;12307873;-6525210
15/11/2009;17;TO;9927561;9370345;557216
15/12/2009;12;AC;1440861;57212;1383649
15/12/2009;27;AL;166834383;11827602;155006781
15/12/2009;16;AP;21784226;2941615;18842611
15/12/2009;13;AM;90320011;631895672;-541575661
15/12/2009;29;BA;657565064;432884578;224680486
15/12/2009;23;CE;107369159;105404211;1964948
15/12/2009;53;DF;11030704;102784025;-91753321
15/12/2009;32;ES;576084580;501903211;74181369
15/12/2009;52;GO;281746503;322808782;-41062279
15/12/2009;21;MA;59412174;195083855;-135671681
15/12/2009;51;MT;543334747;49161524;494173223
15/12/2009;50;MS;147480441;213287089;-65806648
15/12/2009;31;MG;1779740568;598248744;1181491824
15/12/2009;15;PA;822159239;64675616;757483623
15/12/2009;25;PB;14941193;29514706;-14573513
15/12/2009;41;PR;791349929;882685972;-91336043
15/12/2009;26;PE;96650646;201836893;-105186247
15/12/2009;22;PI;7389777;12005286;-4615509
15/12/2009;33;RJ;1280036434;1750295351;-470258917
15/12/2009;24;RN;23684616;12161796;11522820
15/12/2009;43;RS;1827305612;659817127;1167488485
15/12/2009;11;RO;38229795;15227396;23002399
15/12/2009;14;RR;456178;675122;-218944
15/12/2009;42;SC;584686402;781442057;-196755655
15/12/2009;35;SP;4178685729;4705391646;-526705917
15/12/2009;28;SE;5618410;10018976;-4400566
15/12/2009;17;TO;8817211;12907195;-4089984
15/01/2010;12;AC;1276846;150999;1125847
15/01/2010;27;AL;106940967;12759423;94181544
15/01/2010;16;AP;14088607;2572045;11516562
15/01/2010;13;AM;61326939;599534750;-538207811
15/01/2010;29;BA;804321173;482367495;321953678
15/01/2010;23;CE;100658328;116561569;-15903241
15/01/2010;53;DF;8758524;54430714;-45672190
15/01/2010;32;ES;554694300;461788301;92905999
15/01/2010;52;GO;159878122;356105294;-196227172
15/01/2010;21;MA;81763196;119623465;-37860269
15/01/2010;51;MT;438784177;72032305;366751872
15/01/2010;50;MS;86577206;219230700;-132653494
15/01/2010;31;MG;1471557122;605061124;866495998
15/01/2010;15;PA;656446899;106834098;549612801
15/01/2010;25;PB;15472776;32258407;-16785631
15/01/2010;41;PR;700788596;906962933;-206174337
15/01/2010;26;PE;155835460;194491984;-38656524
15/01/2010;22;PI;5912745;15319287;-9406542
15/01/2010;33;RJ;1124534260;1119309343;5224917
15/01/2010;24;RN;20622155;59571715;-38949560
15/01/2010;43;RS;835957322;648316601;187640721
15/01/2010;11;RO;21612405;14037523;7574882
15/01/2010;14;RR;830308;227363;602945
15/01/2010;42;SC;425323188;761493070;-336169882
15/01/2010;35;SP;3093253190;4517274936;-1424021746
15/01/2010;28;SE;4011874;9959006;-5947132
15/01/2010;17;TO;7906585;15390592;-7484007
15/02/2010;12;AC;1468667;57162;1411505
15/02/2010;27;AL;164092943;14666027;149426916
15/02/2010;16;AP;20514044;968421;19545623
15/02/2010;13;AM;74838588;732244020;-657405432
15/02/2010;29;BA;524319446;488614473;35704973
15/02/2010;23;CE;98864156;96343238;2520918
15/02/2010;53;DF;7129027;165886466;-158757439
15/02/2010;32;ES;643013397;448379418;194633979
15/02/2010;52;GO;241390353;242451726;-1061373
15/02/2010;21;MA;271450482;276681461;-5230979
15/02/2010;51;MT;534482851;72176473;462306378
15/02/2010;50;MS;117764249;220841282;-103077033
15/02/2010;31;MG;1629621481;598102332;1031519149
15/02/2010;15;PA;584502346;63528476;520973870
15/02/2010;25;PB;17060207;46539516;-29479309
15/02/2010;41;PR;704786790;807516391;-102729601
15/02/2010;26;PE;60848175;193556076;-132707901
15/02/2010;22;PI;3932237;11334747;-7402510
15/02/2010;33;RJ;1452838252;1150669913;302168339
15/02/2010;24;RN;23827829;13604986;10222843
15/02/2010;43;RS;870677538;770041363;100636175
15/02/2010;11;RO;33290700;13514565;19776135
15/02/2010;14;RR;1715866;448924;1266942
15/02/2010;42;SC;509119133;783222352;-274103219
15/02/2010;35;SP;3186059958;4566076963;-1380017005
15/02/2010;28;SE;6931656;13154349;-6222693
15/02/2010;17;TO;7987921;22469589;-14481668
15/03/2010;12;AC;2304599;86653;2217946
15/03/2010;27;AL;102797526;15098893;87698633
15/03/2010;16;AP;20702005;3117014;17584991
15/03/2010;13;AM;101418890;889490029;-788071139
15/03/2010;29;BA;730614813;587367817;143246996
15/03/2010;23;CE;113129181;154777412;-41648231
15/03/2010;53;DF;12079457;335775500;-323696043
15/03/2010;32;ES;768308383;599735259;168573124
15/03/2010;52;GO;384149020;338602553;45546467
15/03/2010;21;MA;484904959;397976976;86927983
15/03/2010;51;MT;988089533;80933943;907155590
15/03/2010;50;MS;210160311;254212734;-44052423
15/03/2010;31;MG;2074270863;784156820;1290114043
15/03/2010;15;PA;497744666;85997538;411747128
15/03/2010;25;PB;15829822;49382976;-33553154
15/03/2010;41;PR;1093042112;922897593;170144519
15/03/2010;26;PE;87804373;233019531;-145215158
15/03/2010;22;PI;7040486;4159225;2881261
15/03/2010;33;RJ;1604063220;1640864471;-36801251
15/03/2010;24;RN;23028780;11277094;11751686
15/03/2010;43;RS;1007993773;878038664;129955109
15/03/2010;11;RO;30843162;23972269;6870893
15/03/2010;14;RR;1615827;1071958;543869
15/03/2010;42;SC;637614491;972978130;-335363639
15/03/2010;35;SP;4322288482;5751872828;-1429584346
15/03/2010;28;SE;5830392;17568666;-11738274
15/03/2010;17;TO;9761649;19841100;-10079451
15/04/2010;12;AC;1918005;126683;1791322
15/04/2010;27;AL;70475777;16345822;54129955
15/04/2010;16;AP;17688338;3117223;14571115
15/04/2010;13;AM;104793296;824931647;-720138351
15/04/2010;29;BA;627149643;553921358;73228285
15/04/2010;23;CE;92253445;141815786;-49562341
15/04/2010;53;DF;13893818;52114154;-38220336
15/04/2010;32;ES;691001627;555491750;135509877
15/04/2010;52;GO;357830371;297896918;59933453
15/04/2010;21;MA;322425729;393879396;-71453667
15/04/2010;51;MT;922462031;83869824;838592207
15/04/2010;50;MS;258085032;263324780;-5239748
15/04/2010;31;MG;2102733162;727202968;1375530194
15/04/2010;15;PA;495236760;58429073;436807687
15/04/2010;25;PB;17303333;54243956;-36940623
15/04/2010;41;PR;1295711292;1005954545;289756747
15/04/2010;26;PE;98889806;280378118;-181488312
15/04/2010;22;PI;6227569;12505141;-6277572
15/04/2010;33;RJ;1492414518;1537066187;-44651669
15/04/2010;24;RN;33129075;88458454;-55329379
15/04/2010;43;RS;1348797386;702829767;645967619
15/04/2010;11;RO;62519984;15873891;46646093
15/04/2010;14;RR;1016680;341743;674937
15/04/2010;42;SC;625390466;792767185;-167376719
15/04/2010;35;SP;3686152426;5390604726;-1704452300
15/04/2010;28;SE;3482332;13894565;-10412233
15/04/2010;17;TO;51745747;11505343;40240404
15/05/2010;12;AC;1680614;617836;1062778
15/05/2010;27;AL;79709461;12434350;67275111
15/05/2010;16;AP;14719885;2250700;12469185
15/05/2010;13;AM;102249644;927744240;-825494596
15/05/2010;29;BA;730261726;564950526;165311200
15/05/2010;23;CE;90296898;154368239;-64071341
15/05/2010;53;DF;13482668;177864746;-164382078
15/05/2010;32;ES;826417479;589393832;237023647
15/05/2010;52;GO;427435850;346704456;80731394
15/05/2010;21;MA;199717294;220855268;-21137974
15/05/2010;51;MT;891981168;94503417;797477751
15/05/2010;50;MS;298092675;237325021;60767654
15/05/2010;31;MG;2505669526;836007926;1669661600
15/05/2010;15;PA;950781863;115466191;835315672
15/05/2010;25;PB;15465907;44621227;-29155320
15/05/2010;41;PR;1357578594;1053407707;304170887
15/05/2010;26;PE;69289869;215362491;-146072622
15/05/2010;22;PI;24650744;33910684;-9259940
15/05/2010;33;RJ;2120643379;1402461402;718181977
15/05/2010;24;RN;18960801;11435163;7525638
15/05/2010;43;RS;1565572306;775885255;789687051
15/05/2010;11;RO;51038633;15436524;35602109
15/05/2010;14;RR;656483;445013;211470
15/05/2010;42;SC;698919135;890533904;-191614769
15/05/2010;35;SP;4243975944;5485017315;-1241041371
15/05/2010;28;SE;3081858;14373951;-11292093
15/05/2010;17;TO;53146071;20998693;32147378
15/06/2010;12;AC;1520691;454767;1065924
15/06/2010;27;AL;23303546;52552664;-29249118
15/06/2010;16;AP;32420704;1227354;31193350
15/06/2010;13;AM;93634270;959230428;-865596158
15/06/2010;29;BA;716190555;550544805;165645750
15/06/2010;23;CE;98800187;110471616;-11671429
15/06/2010;53;DF;11920034;123631634;-111711600
15/06/2010;32;ES;1051766422;632985468;418780954
15/06/2010;52;GO;442971188;333520297;109450891
15/06/2010;21;MA;223396646;252492285;-29095639
15/06/2010;51;MT;768117896;45003209;723114687
15/06/2010;50;MS;270371006;287839674;-17468668
15/06/2010;31;MG;2521628026;867517327;1654110699
15/06/2010;15;PA;1039500619;138637943;900862676
15/06/2010;25;PB;13513741;40615026;-27101285
15/06/2010;41;PR;1241178402;1143252358;97926044
15/06/2010;26;PE;43567798;203471440;-159903642
15/06/2010;22;PI;9973819;13161801;-3187982
15/06/2010;33;RJ;1383354447;1423521562;-40167115
15/06/2010;24;RN;17731067;24343753;-6612686
15/06/2010;43;RS;1486538554;1027577649;458960905
15/06/2010;11;RO;64625910;23464128;41161782
15/06/2010;14;RR;554525;640347;-85822
15/06/2010;42;SC;640573228;904418529;-263845301
15/06/2010;35;SP;4418333967;5642582836;-1224248869
15/06/2010;28;SE;4005127;15584617;-11579490
15/06/2010;17;TO;57174454;10048836;47125618
15/07/2010;12;AC;1777731;337355;1440376
15/07/2010;27;AL;9796238;21570995;-11774757
15/07/2010;16;AP;32907217;7593424;25313793
15/07/2010;13;AM;110924670;1120296229;-1009371559
15/07/2010;29;BA;739015207;579405906;159609301
15/07/2010;23;CE;112175163;169559868;-57384705
15/07/2010;53;DF;19475360;123448653;-103973293
15/07/2010;32;ES;1043756130;667996415;375759715
15/07/2010;52;GO;381916927;354566800;27350127
15/07/2010;21;MA;190750604;274451165;-83700561
15/07/2010;51;MT;807753718;110103311;697650407
15/07/2010;50;MS;303286979;320124368;-16837389
15/07/2010;31;MG;2817339334;921308686;1896030648
15/07/2010;15;PA;1263559882;110952112;1152607770
15/07/2010;25;PB;18276407;110374507;-92098100
15/07/2010;41;PR;1370165553;1302363887;67801666
15/07/2010;26;PE;54082862;348354659;-294271797
15/07/2010;22;PI;21643107;26913235;-5270128
15/07/2010;33;RJ;1096509376;1723348950;-626839574
15/07/2010;24;RN;17153097;17819776;-666679
15/07/2010;43;RS;1568444131;922975224;645468907
15/07/2010;11;RO;33521463;15938434;17583029
15/07/2010;14;RR;550634;853692;-303058
15/07/2010;42;SC;734265419;1005723102;-271457683
15/07/2010;35;SP;4494476725;6033768409;-1539291684
15/07/2010;28;SE;6378912;16371040;-9992128
15/07/2010;17;TO;36128942;24324248;11804694
15/08/2010;12;AC;2154231;115699;2038532
15/08/2010;27;AL;13571423;16331470;-2760047
15/08/2010;16;AP;61846934;3244988;58601946
15/08/2010;13;AM;104361580;1160183661;-1055822081
15/08/2010;29;BA;834771952;489048440;345723512
15/08/2010;23;CE;98179333;273850515;-175671182
15/08/2010;53;DF;13302537;111537205;-98234668
15/08/2010;32;ES;1111865450;730616982;381248468
15/08/2010;52;GO;360542278;345546632;14995646
15/08/2010;21;MA;260384155;368700738;-108316583
15/08/2010;51;MT;636694492;40088911;596605581
15/08/2010;50;MS;331288233;303847394;27440839
15/08/2010;31;MG;3321406015;944957508;2376448507
15/08/2010;15;PA;1585947986;91202443;1494745543
15/08/2010;25;PB;18721283;65649824;-46928541
15/08/2010;41;PR;1434610407;1371448693;63161714
15/08/2010;26;PE;51562430;299987137;-248424707
15/08/2010;22;PI;14654309;12385273;2269036
15/08/2010;33;RJ;1514373980;1959846420;-445472440
15/08/2010;24;RN;16288384;22013017;-5724633
15/08/2010;43;RS;1370869010;949366524;421502486
15/08/2010;11;RO;37159651;21017299;16142352
15/08/2010;14;RR;959242;672946;286296
15/08/2010;42;SC;692021439;1032113570;-340092131
15/08/2010;35;SP;4777229806;6191372557;-1414142751
15/08/2010;28;SE;7716516;15563291;-7846775
15/08/2010;17;TO;61178978;8139100;53039878
15/09/2010;12;AC;1597694;65184;1532510
15/09/2010;27;AL;16832154;13417400;3414754
15/09/2010;16;AP;39912885;2763021;37149864
15/09/2010;13;AM;85468148;1171869061;-1086400913
15/09/2010;29;BA;897343642;682384481;214959161
15/09/2010;23;CE;105693951;204501845;-98807894
15/09/2010;53;DF;15195883;123237488;-108041605
15/09/2010;32;ES;1018198684;767389501;250809183
15/09/2010;52;GO;344350155;399325732;-54975577
15/09/2010;21;MA;233838742;383838301;-149999559
15/09/2010;51;MT;713475015;76461453;637013562
15/09/2010;50;MS;289717644;330497597;-40779953
15/09/2010;31;MG;3267480931;1096539797;2170941134
15/09/2010;15;PA;1366075192;66126756;1299948436
15/09/2010;25;PB;15695140;68275160;-52580020
15/09/2010;41;PR;1343371362;1385527572;-42156210
15/09/2010;26;PE;63826037;248772372;-184946335
15/09/2010;22;PI;6743954;14715544;-7971590
15/09/2010;33;RJ;1604242144;2073215813;-468973669
15/09/2010;24;RN;21066575;22967213;-1900638
15/09/2010;43;RS;1435582980;1062348041;373234939
15/09/2010;11;RO;22037947;22213542;-175595
15/09/2010;14;RR;1231835;952199;279636
15/09/2010;42;SC;654944666;1090043400;-435098734
15/09/2010;35;SP;4851887460;6398350244;-1546462784
15/09/2010;28;SE;7451892;11813807;-4361915
15/09/2010;17;TO;29536362;41759656;-12223294
15/10/2010;12;AC;2404399;343737;2060662
15/10/2010;27;AL;48215352;13099906;35115446
15/10/2010;16;AP;28072819;5420822;22651997
15/10/2010;13;AM;88872095;1029186118;-940314023
15/10/2010;29;BA;766209376;574626115;191583261
15/10/2010;23;CE;102316190;241648476;-139332286
15/10/2010;53;DF;13925502;92053888;-78128386
15/10/2010;32;ES;1275414589;615811864;659602725
15/10/2010;52;GO;385402408;397866856;-12464448
15/10/2010;21;MA;228791180;343383802;-114592622
15/10/2010;51;MT;546860800;78058630;468802170
15/10/2010;50;MS;269295920;324144144;-54848224
15/10/2010;31;MG;3206676387;904467752;2302208635
15/10/2010;15;PA;1511284075;107386513;1403897562
15/10/2010;25;PB;17632420;53939540;-36307120
15/10/2010;41;PR;1212578952;1432695842;-220116890
15/10/2010;26;PE;153805452;278776535;-124971083
15/10/2010;22;PI;15864400;20215439;-4351039
15/10/2010;33;RJ;993649086;1595117422;-601468336
15/10/2010;24;RN;27121724;14645702;12476022
15/10/2010;43;RS;1419275231;1055912460;363362771
15/10/2010;11;RO;26468694;20673137;5795557
15/10/2010;14;RR;330601;705760;-375159
15/10/2010;42;SC;649596050;1087904860;-438308810
15/10/2010;35;SP;4848870218;6231748219;-1382878001
15/10/2010;28;SE;10856474;13566370;-2709896
15/10/2010;17;TO;22895245;18817381;4077864
15/11/2010;12;AC;1501440;242463;1258977
15/11/2010;27;AL;168716723;23746659;144970064
15/11/2010;16;AP;33047410;7843266;25204144
15/11/2010;13;AM;86099552;920001887;-833902335
15/11/2010;29;BA;679361676;637728094;41633582
15/11/2010;23;CE;122431678;263288343;-140856665
15/11/2010;53;DF;12029330;110657315;-98627985
15/11/2010;32;ES;1127755216;774990654;352764562
15/11/2010;52;GO;327571955;374457251;-46885296
15/11/2010;21;MA;167691617;552671583;-384979966
15/11/2010;51;MT;577209448;118674919;458534529
15/11/2010;50;MS;235235633;330003109;-94767476
15/11/2010;31;MG;2899961584;899852499;2000109085
15/11/2010;15;PA;1259843829;98849377;1160994452
15/11/2010;25;PB;24563648;72593947;-48030299
15/11/2010;41;PR;1160619566;1380607847;-219988281
15/11/2010;26;PE;141998171;326085898;-184087727
15/11/2010;22;PI;6361933;13543068;-7181135
15/11/2010;33;RJ;1642588184;1681169909;-38581725
15/11/2010;24;RN;30747198;11083399;19663799
15/11/2010;43;RS;1149049313;994705910;154343403
15/11/2010;11;RO;16508840;28526418;-12017578
15/11/2010;14;RR;1291812;569657;722155
15/11/2010;42;SC;593829857;1228510971;-634681114
15/11/2010;35;SP;4830063616;6507782495;-1677718879
15/11/2010;28;SE;7054059;20761414;-13707355
15/11/2010;17;TO;2504053;25632155;-23128102
15/12/2010;12;AC;1129368;358776;770592
15/12/2010;27;AL;166142556;37089282;129053274
15/12/2010;16;AP;34622666;9029518;25593148
15/12/2010;13;AM;89880252;796097800;-706217548
15/12/2010;29;BA;807851733;519908611;287943122
15/12/2010;23;CE;132613658;258121077;-125507419
15/12/2010;53;DF;11040016;108172570;-97132554
15/12/2010;32;ES;1266690031;654992068;611697963
15/12/2010;52;GO;227782317;368697797;-140915480
15/12/2010;21;MA;254380673;232187786;22192887
15/12/2010;51;MT;633026066;114849073;518176993
15/12/2010;50;MS;219096678;308562583;-89465905
15/12/2010;31;MG;3347149096;781142430;2566006666
15/12/2010;15;PA;1622218829;105148790;1517070039
15/12/2010;25;PB;27376245;43599394;-16223149
15/12/2010;41;PR;1121562149;1246915107;-125352958
15/12/2010;26;PE;126704353;452615243;-325910890
15/12/2010;22;PI;6169862;11749722;-5579860
15/12/2010;33;RJ;3408976543;1710779763;1698196780
15/12/2010;24;RN;34449789;20147814;14301975
15/12/2010;43;RS;1244800145;998145064;246655081
15/12/2010;11;RO;25157206;29785200;-4627994
15/12/2010;14;RR;551240;727387;-176147
15/12/2010;42;SC;692673199;1093224347;-400551148
15/12/2010;35;SP;4875155359;5646344744;-771189385
15/12/2010;28;SE;11386959;7533440;3853519
15/12/2010;17;TO;3956869;18933723;-14976854
15/01/2011;12;AC;2780253;2444137;336116
15/01/2011;27;AL;167282406;35361089;131921317
15/01/2011;16;AP;53157160;1665574;51491586
15/01/2011;13;AM;73834845;862427503;-788592658
15/01/2011;29;BA;600693919;547239973;53453946
15/01/2011;23;CE;108648036;123158028;-14509992
15/01/2011;53;DF;11870868;81889107;-70018239
15/01/2011;32;ES;1100585164;699407812;401177352
15/01/2011;52;GO;432157247;394758542;37398705
15/01/2011;21;MA;175419864;161227180;14192684
15/01/2011;51;MT;483062082;100759325;382302757
15/01/2011;50;MS;164764011;294112849;-129348838
15/01/2011;31;MG;2728378987;886250690;1842128297
15/01/2011;15;PA;1137576636;110786173;1026790463
15/01/2011;25;PB;23374151;47191129;-23816978
15/01/2011;41;PR;858143377;1282616715;-424473338
15/01/2011;26;PE;127357049;288369591;-161012542
15/01/2011;22;PI;3105645;9551862;-6446217
15/01/2011;33;RJ;1587933062;1181911199;406021863
15/01/2011;24;RN;18448944;13844821;4604123
15/01/2011;43;RS;1098947153;926418631;172528522
15/01/2011;11;RO;23620373;15995304;7625069
15/01/2011;14;RR;3188134;549250;2638884
15/01/2011;42;SC;523916317;1010296247;-486379930
15/01/2011;35;SP;3287481927;5712097792;-2424615865
15/01/2011;28;SE;6817214;13031143;-6213929
15/01/2011;17;TO;6469290;14094630;-7625340
15/02/2011;12;AC;2013902;134286;1879616
15/02/2011;27;AL;140781728;23893575;116888153
15/02/2011;16;AP;31245202;4857069;26388133
15/02/2011;13;AM;74763702;942626300;-867862598
15/02/2011;29;BA;667084788;364076916;303007872
15/02/2011;23;CE;104842576;149114691;-44272115
15/02/2011;53;DF;8088100;52876981;-44788881
15/02/2011;32;ES;1120689276;775124839;345564437
15/02/2011;52;GO;290703410;390312573;-99609163
15/02/2011;21;MA;184462595;285495823;-101033228
15/02/2011;51;MT;495681787;78154964;417526823
15/02/2011;50;MS;177868678;292031588;-114162910
15/02/2011;31;MG;2683745169;827687456;1856057713
15/02/2011;15;PA;1183377077;83450683;1099926394
15/02/2011;25;PB;12918295;75456971;-62538676
15/02/2011;41;PR;1024776148;1174918753;-150142605
15/02/2011;26;PE;79299625;380631374;-301331749
15/02/2011;22;PI;4220101;3407802;812299
15/02/2011;33;RJ;2069093418;1849414863;219678555
15/02/2011;24;RN;17306473;13511524;3794949
15/02/2011;43;RS;1162927807;883891229;279036578
15/02/2011;11;RO;25487288;24568084;919204
15/02/2011;14;RR;656975;857627;-200652
15/02/2011;42;SC;618436353;1043164143;-424727790
15/02/2011;35;SP;4062510806;5791454598;-1728943792
15/02/2011;28;SE;12260469;26199854;-13939385
15/02/2011;17;TO;6735079;9577450;-2842371
15/03/2011;12;AC;1971836;204106;1767730
15/03/2011;27;AL;254206189;31571150;222635039
15/03/2011;16;AP;62437182;2763849;59673333
15/03/2011;13;AM;73054863;1009011912;-935957049
15/03/2011;29;BA;758451603;559310264;199141339
15/03/2011;23;CE;101840195;172648263;-70808068
15/03/2011;53;DF;12949434;128456637;-115507203
15/03/2011;32;ES;1133030558;818397550;314633008
15/03/2011;52;GO;517189140;422593422;94595718
15/03/2011;21;MA;203046150;394802020;-191755870
15/03/2011;51;MT;1017831552;93045526;924786026
15/03/2011;50;MS;330531142;317932650;12598492
15/03/2011;31;MG;3091407739;914618683;2176789056
15/03/2011;15;PA;1123440808;138785780;984655028
15/03/2011;25;PB;15837218;210566723;-194729505
15/03/2011;41;PR;1312105263;1352270955;-40165692
15/03/2011;26;PE;88374709;388794784;-300420075
15/03/2011;22;PI;5601656;4648211;953445
15/03/2011;33;RJ;1753047451;1562468399;190579052
15/03/2011;24;RN;19231771;14179277;5052494
15/03/2011;43;RS;1506800794;915186782;591614012
15/03/2011;11;RO;45294000;30689828;14604172
15/03/2011;14;RR;2246134;754929;1491205
15/03/2011;42;SC;733114462;1183318606;-450204144
15/03/2011;35;SP;4659573642;7019818250;-2360244608
15/03/2011;28;SE;10357814;32798718;-22440904
15/03/2011;17;TO;10645746;15084816;-4439070
15/04/2011;12;AC;1857439;200433;1657006
15/04/2011;27;AL;177364110;31960118;145403992
15/04/2011;16;AP;49386899;2871145;46515754
15/04/2011;13;AM;49434072;991128020;-941693948
15/04/2011;29;BA;793356701;665813708;127542993
15/04/2011;23;CE;92083180;148434355;-56351175
15/04/2011;53;DF;12579242;85896474;-73317232
15/04/2011;32;ES;1129677666;723309033;406368633
15/04/2011;52;GO;562268698;426298296;135970402
15/04/2011;21;MA;295152945;595126020;-299973075
15/04/2011;51;MT;1100418213;177797299;922620914
15/04/2011;50;MS;375207957;352367596;22840361
15/04/2011;31;MG;3129513501;889450662;2240062839
15/04/2011;15;PA;1422653805;118655824;1303997981
15/04/2011;25;PB;14308162;75807135;-61498973
15/04/2011;41;PR;1556647747;1460120966;96526781
15/04/2011;26;PE;90922486;386381665;-295459179
15/04/2011;22;PI;5376501;4341885;1034616
15/04/2011;33;RJ;1954476177;1975212986;-20736809
15/04/2011;24;RN;14998377;19703364;-4704987
15/04/2011;43;RS;1455119303;1063350096;391769207
15/04/2011;11;RO;32525342;19794277;12731065
15/04/2011;14;RR;935051;647283;287768
15/04/2011;42;SC;736392876;1132766508;-396373632
15/04/2011;35;SP;4583250992;6925224617;-2341973625
15/04/2011;28;SE;10502230;32024974;-21522744
15/04/2011;17;TO;79676990;13076286;66600704
15/05/2011;12;AC;1250574;281331;969243
15/05/2011;27;AL;49489905;45839239;3650666
15/05/2011;16;AP;25492645;2692202;22800443
15/05/2011;13;AM;71132123;1142251890;-1071119767
15/05/2011;29;BA;1015304323;761736931;253567392
15/05/2011;23;CE;96372388;180800694;-84428306
15/05/2011;53;DF;12562999;102786168;-90223169
15/05/2011;32;ES;1276552157;946061489;330490668
15/05/2011;52;GO;539084186;424576889;114507297
15/05/2011;21;MA;234825357;463907895;-229082538
15/05/2011;51;MT;1015262301;194647432;820614869
15/05/2011;50;MS;364967096;317088273;47878823
15/05/2011;31;MG;3524066657;1175452256;2348614401
15/05/2011;15;PA;1494366879;120691845;1373675034
15/05/2011;25;PB;8592599;117870483;-109277884
15/05/2011;41;PR;1692407976;1685363042;7044934
15/05/2011;26;PE;35284254;343372894;-308088640
15/05/2011;22;PI;17802378;9356048;8446330
15/05/2011;33;RJ;3191411328;2055592162;1135819166
15/05/2011;24;RN;18952396;30668340;-11715944
15/05/2011;43;RS;2026526795;935184608;1091342187
15/05/2011;11;RO;64120905;23605529;40515376
15/05/2011;14;RR;1121483;260479;861004
15/05/2011;42;SC;851516165;1201376489;-349860324
15/05/2011;35;SP;4915059107;7351806673;-2436747566
15/05/2011;28;SE;6371126;21049977;-14678851
15/05/2011;17;TO;85060943;25436053;59624890
15/06/2011;12;AC;1709589;99941;1609648
15/06/2011;27;AL;11033239;36701298;-25668059
15/06/2011;16;AP;39406347;5723324;33683023
15/06/2011;13;AM;65148503;1168214258;-1103065755
15/06/2011;29;BA;1047807639;770550433;277257206
15/06/2011;23;CE;105664489;170960886;-65296397
15/06/2011;53;DF;19704569;95141655;-75437086
15/06/2011;32;ES;1282598118;787540358;495057760
15/06/2011;52;GO;460866447;479987102;-19120655
15/06/2011;21;MA;297856224;492406384;-194550160
15/06/2011;51;MT;988851675;138174916;850676759
15/06/2011;50;MS;361688738;338160567;23528171
15/06/2011;31;MG;3498875516;1057361352;2441514164
15/06/2011;15;PA;1445439649;104298023;1341141626
15/06/2011;25;PB;11948172;107388318;-95440146
15/06/2011;41;PR;1730660651;1657391386;73269265
15/06/2011;26;PE;43899947;404199383;-360299436
15/06/2011;22;PI;13376651;5248947;8127704
15/06/2011;33;RJ;2488203474;1973777648;514425826
15/06/2011;24;RN;16534811;22462670;-5927859
15/06/2011;43;RS;1965705685;1072190964;893514721
15/06/2011;11;RO;53758206;42830336;10927870
15/06/2011;14;RR;755346;1064160;-308814
15/06/2011;42;SC;825452342;1129099881;-303647539
15/06/2011;35;SP;5264641677;7143793013;-1879151336
15/06/2011;28;SE;4668645;30315847;-25647202
15/06/2011;17;TO;87192687;15955344;71237343
15/07/2011;12;AC;1271789;415192;856597
15/07/2011;27;AL;20771902;33308761;-12536859
15/07/2011;16;AP;35985037;2485029;33500008
15/07/2011;13;AM;81393373;1284666457;-1203273084
15/07/2011;29;BA;1014049167;649293459;364755708
15/07/2011;23;CE;114633818;237827022;-123193204
15/07/2011;53;DF;21563958;93432912;-71868954
15/07/2011;32;ES;1239597266;932929336;306667930
15/07/2011;52;GO;455798791;477182756;-21383965
15/07/2011;21;MA;272654135;461284180;-188630045
15/07/2011;51;MT;919187261;180304144;738883117
15/07/2011;50;MS;339772870;399565481;-59792611
15/07/2011;31;MG;3569127580;1052953204;2516174376
15/07/2011;15;PA;1709410850;119042277;1590368573
15/07/2011;25;PB;12450373;69729430;-57279057
15/07/2011;41;PR;1489025105;1453985852;35039253
15/07/2011;26;PE;43893412;381791126;-337897714
15/07/2011;22;PI;28232721;31715680;-3482959
15/07/2011;33;RJ;2449359641;1749705218;699654423
15/07/2011;24;RN;24883311;23011274;1872037
15/07/2011;43;RS;1781691465;1108784597;672906868
15/07/2011;11;RO;45642856;44301278;1341578
15/07/2011;14;RR;1900802;356455;1544347
15/07/2011;42;SC;783800776;1210890211;-427089435
15/07/2011;35;SP;5297511170;7057084298;-1759573128
15/07/2011;28;SE;11304930;34613181;-23308251
15/07/2011;17;TO;24239326;20419281;3820045
15/08/2011;12;AC;854636;835674;18962
15/08/2011;27;AL;735454;30023579;-29288125
15/08/2011;16;AP;89781810;4820428;84961382
15/08/2011;13;AM;75995087;1252991932;-1176996845
15/08/2011;29;BA;1159602647;725507734;434094913
15/08/2011;23;CE;191104642;355392744;-164288102
15/08/2011;53;DF;16521447;119673525;-103152078
15/08/2011;32;ES;1539845822;995691655;544154167
15/08/2011;52;GO;601753862;502371857;99382005
15/08/2011;21;MA;323602147;722189150;-398587003
15/08/2011;51;MT;1109031029;153092608;955938421
15/08/2011;50;MS;360007118;435710087;-75702969
15/08/2011;31;MG;4110722198;1365306038;2745416160
15/08/2011;15;PA;2031622791;117256405;1914366386
15/08/2011;25;PB;10582149;92418782;-81836633
15/08/2011;41;PR;1808722248;1882349363;-73627115
15/08/2011;26;PE;51808413;574758621;-522950208
15/08/2011;22;PI;28645107;23195689;5449418
15/08/2011;33;RJ;3076172050;2084100114;992071936
15/08/2011;24;RN;20121593;12038627;8082966
15/08/2011;43;RS;1858505833;1303345494;555160339
15/08/2011;11;RO;42920467;34946374;7974093
15/08/2011;14;RR;1590680;356928;1233752
15/08/2011;42;SC;782146193;1413212321;-631066128
15/08/2011;35;SP;6217228005;8022591280;-1805363275
15/08/2011;28;SE;16830802;28075710;-11244908
15/08/2011;17;TO;68023380;8874388;59148992
15/09/2011;12;AC;1032257;136724;895533
15/09/2011;27;AL;3260353;28376122;-25115769
15/09/2011;16;AP;55398391;5661451;49736940
15/09/2011;13;AM;79942031;1188620551;-1108678520
15/09/2011;29;BA;1016234696;719774722;296459974
15/09/2011;23;CE;106281721;202753363;-96471642
15/09/2011;53;DF;12479783;132232995;-119753212
15/09/2011;32;ES;1233579230;836447809;397131421
15/09/2011;52;GO;433650893;533866024;-100215131
15/09/2011;21;MA;345676092;694349603;-348673511
15/09/2011;51;MT;1065661128;80431618;985229510
15/09/2011;50;MS;454997113;435080190;19916923
15/09/2011;31;MG;3893129023;1113534442;2779594581
15/09/2011;15;PA;1870334356;113430617;1756903739
15/09/2011;25;PB;16907984;54042558;-37134574
15/09/2011;41;PR;1630894889;1751498283;-120603394
15/09/2011;26;PE;124843471;561726137;-436882666
15/09/2011;22;PI;24097630;25138181;-1040551
15/09/2011;33;RJ;1880801086;1835495014;45306072
15/09/2011;24;RN;23931079;26177805;-2246726
15/09/2011;43;RS;2079080755;1185775798;893304957
15/09/2011;11;RO;20796207;60491999;-39695792
15/09/2011;14;RR;1049152;692662;356490
15/09/2011;42;SC;728122043;1299059546;-570937503
15/09/2011;35;SP;5537339907;7305104354;-1767764447
15/09/2011;28;SE;9701516;13273740;-3572224
15/09/2011;17;TO;58849022;8843720;50005302
15/10/2011;12;AC;1088507;197927;890580
15/10/2011;27;AL;164867234;46481394;118385840
15/10/2011;16;AP;55235077;6853884;48381193
15/10/2011;13;AM;77597814;1059401253;-981803439
15/10/2011;29;BA;949465931;705440987;244024944
15/10/2011;23;CE;126109952;204222396;-78112444
15/10/2011;53;DF;15572710;114019903;-98447193
15/10/2011;32;ES;1277068470;819750070;457318400
15/10/2011;52;GO;483652769;516605608;-32952839
15/10/2011;21;MA;225699981;647947303;-422247322
15/10/2011;51;MT;1035634272;93604705;942029567
15/10/2011;50;MS;348273381;412512115;-64238734
15/10/2011;31;MG;3885232492;1136331577;2748900915
15/10/2011;15;PA;1483130965;89643678;1393487287
15/10/2011;25;PB;37333087;63103342;-25770255
15/10/2011;41;PR;1389092986;1662793787;-273700801
15/10/2011;26;PE;156550822;592501559;-435950737
15/10/2011;22;PI;14930482;15280799;-350317
15/10/2011;33;RJ;2162963401;1972599733;190363668
15/10/2011;24;RN;35672632;19843408;15829224
15/10/2011;43;RS;1704962359;1274724483;430237876
15/10/2011;11;RO;48513910;26421313;22092597
15/10/2011;14;RR;744466;486687;257779
15/10/2011;42;SC;814442118;1321913538;-507471420
15/10/2011;35;SP;5144880269;6953129197;-1808248928
15/10/2011;28;SE;14859007;9928908;4930099
15/10/2011;17;TO;20856943;9385179;11471764
15/11/2011;12;AC;702571;264644;437927
15/11/2011;27;AL;157768864;48096867;109671997
15/11/2011;16;AP;70656245;4915407;65740838
15/11/2011;13;AM;80390176;1060069133;-979678957
15/11/2011;29;BA;971323091;676247846;295075245
15/11/2011;23;CE;120384825;212498204;-92113379
15/11/2011;53;DF;17679828;124741162;-107061334
15/11/2011;32;ES;1071325667;1190289293;-118963626
15/11/2011;52;GO;407614677;598589658;-190974981
15/11/2011;21;MA;263750615;765070265;-501319650
15/11/2011;51;MT;1024609779;160054912;864554867
15/11/2011;50;MS;335441612;457136804;-121695192
15/11/2011;31;MG;3822070974;1710184779;2111886195
15/11/2011;15;PA;1816350013;136679595;1679670418
15/11/2011;25;PB;37213224;49540035;-12326811
15/11/2011;41;PR;1370139770;1826656550;-456516780
15/11/2011;26;PE;213796389;722917108;-509120719
15/11/2011;22;PI;10132138;12484341;-2352203
15/11/2011;33;RJ;2057034451;1492386676;564647775
15/11/2011;24;RN;32342645;26900874;5441771
15/11/2011;43;RS;1360468477;1480222251;-119753774
15/11/2011;11;RO;45132630;45923385;-790755
15/11/2011;14;RR;448183;705186;-257003
15/11/2011;42;SC;807678359;1383672773;-575994414
15/11/2011;35;SP;5116776896;6973677714;-1856900818
15/11/2011;28;SE;23263546;35648650;-12385104
15/11/2011;17;TO;21655122;7349218;14305904
15/12/2011;12;AC;442932;1563469;-1120537
15/12/2011;27;AL;223627116;61220722;162406394
15/12/2011;16;AP;34549194;22382563;12166631
15/12/2011;13;AM;88038773;743697729;-655658956
15/12/2011;29;BA;942645496;596348458;346297038
15/12/2011;23;CE;132922915;244661234;-111738319
15/12/2011;53;DF;21753351;125492820;-103739469
15/12/2011;32;ES;1414614960;989742956;424872004
15/12/2011;52;GO;407124919;580631816;-173506897
15/12/2011;21;MA;224392275;600532415;-376140140
15/12/2011;51;MT;835865289;153573226;682292063
15/12/2011;50;MS;225997141;423567879;-197570738
15/12/2011;31;MG;3401748397;889831783;2511916614
15/12/2011;15;PA;1617652302;92684191;1524968111
15/12/2011;25;PB;23143833;43380325;-20236492
15/12/2011;41;PR;1426925642;1613954804;-187029162
15/12/2011;26;PE;139820344;529438365;-389618021
15/12/2011;22;PI;8707902;13144926;-4437024
15/12/2011;33;RJ;3045236266;1558597523;1486638743
15/12/2011;24;RN;38279899;20846206;17433693
15/12/2011;43;RS;1360672372;1225212141;135460231
15/12/2011;11;RO;33990595;40863364;-6872769
15/12/2011;14;RR;461779;443171;18608
15/12/2011;42;SC;763786674;1308615707;-544829033
15/12/2011;35;SP;5190863395;6423673048;-1232809653
15/12/2011;28;SE;10143467;17133733;-6990266
15/12/2011;17;TO;16669644;11756653;4912991
15/01/2012;12;AC;972035;172577;799458
15/01/2012;27;AL;223125129;31969064;191156065
15/01/2012;16;AP;45918755;11561785;34356970
15/01/2012;13;AM;60259247;1025391676;-965132429
15/01/2012;29;BA;803632872;659399477;144233395
15/01/2012;23;CE;115720896;264600637;-148879741
15/01/2012;53;DF;14543395;111320321;-96776926
15/01/2012;32;ES;826380100;807541833;18838267
15/01/2012;52;GO;380518322;275825699;104692623
15/01/2012;21;MA;170404629;522529148;-352124519
15/01/2012;51;MT;641340625;120722712;520617913
15/01/2012;50;MS;214335463;358432668;-144097205
15/01/2012;31;MG;2308861450;1035655934;1273205516
15/01/2012;15;PA;985593437;130116397;855477040
15/01/2012;25;PB;26621938;49232660;-22610722
15/01/2012;41;PR;1123796520;1779437282;-655640762
15/01/2012;26;PE;75902788;379347650;-303444862
15/01/2012;22;PI;8851345;13704581;-4853236
15/01/2012;33;RJ;2170830492;1455903911;714926581
15/01/2012;24;RN;27824528;16504308;11320220
15/01/2012;43;RS;1203549706;724600844;478948862
15/01/2012;11;RO;27984743;67898827;-39914084
15/01/2012;14;RR;774433;627428;147005
15/01/2012;42;SC;605846957;1233844066;-627997109
15/01/2012;35;SP;3592905772;6353464288;-2760558516
15/01/2012;28;SE;8784046;10848461;-2064415
15/01/2012;17;TO;13754045;6731548;7022497
15/02/2012;12;AC;1119705;104819;1014886
15/02/2012;27;AL;177219792;41462747;135757045
15/02/2012;16;AP;32971266;4964004;28007262
15/02/2012;13;AM;63800865;984830408;-921029543
15/02/2012;29;BA;916558021;462073295;454484726
15/02/2012;23;CE;102608392;153869550;-51261158
15/02/2012;53;DF;13363489;77842688;-64479199
15/02/2012;32;ES;850825765;721786650;129039115
15/02/2012;52;GO;394944392;422140617;-27196225
15/02/2012;21;MA;181596697;741611665;-560014968
15/02/2012;51;MT;680436172;91079440;589356732
15/02/2012;50;MS;246473767;341463054;-94989287
15/02/2012;31;MG;2631586430;830128950;1801457480
15/02/2012;15;PA;1128068604;119325330;1008743274
15/02/2012;25;PB;34203394;43821271;-9617877
15/02/2012;41;PR;1250389754;1262577874;-12188120
15/02/2012;26;PE;508714271;441633188;67081083
15/02/2012;22;PI;5893229;4143578;1749651
15/02/2012;33;RJ;2427157293;1292057863;1135099430
15/02/2012;24;RN;27620989;14248544;13372445
15/02/2012;43;RS;1179830328;852845121;326985207
15/02/2012;11;RO;35853605;70564017;-34710412
15/02/2012;14;RR;740490;427795;312695
15/02/2012;42;SC;731356890;1216576970;-485220080
15/02/2012;35;SP;4067648384;6114662643;-2047014259
15/02/2012;28;SE;17445678;22308182;-4862504
15/02/2012;17;TO;13384666;6008304;7376362
15/03/2012;12;AC;1291421;52595;1238826
15/03/2012;27;AL;90019773;50098714;39921059
15/03/2012;16;AP;53953813;16063924;37889889
15/03/2012;13;AM;75782516;1162485003;-1086702487
15/03/2012;29;BA;825710266;836661315;-10951049
15/03/2012;23;CE;108889221;192398756;-83509535
15/03/2012;53;DF;18895596;111109989;-92214393
15/03/2012;32;ES;1293034212;707997081;585037131
15/03/2012;52;GO;650044379;507088069;142956310
15/03/2012;21;MA;259606341;595485868;-335879527
15/03/2012;51;MT;1507065094;118005154;1389059940
15/03/2012;50;MS;333284966;411512219;-78227253
15/03/2012;31;MG;2798371225;965793847;1832577378
15/03/2012;15;PA;1102713987;147718969;954995018
15/03/2012;25;PB;19032247;48756026;-29723779
15/03/2012;41;PR;1449442899;1613793867;-164350968
15/03/2012;26;PE;59982457;648494930;-588512473
15/03/2012;22;PI;8096254;4128287;3967967
15/03/2012;33;RJ;2753827674;1423879976;1329947698
15/03/2012;24;RN;20449990;16944202;3505788
15/03/2012;43;RS;1399715450;871697259;528018191
15/03/2012;11;RO;59954675;44137817;15816858
15/03/2012;14;RR;609471;311342;298129
15/03/2012;42;SC;744803504;1217534980;-472731476
15/03/2012;35;SP;4802792373;7148908417;-2346116044
15/03/2012;28;SE;10322377;15733032;-5410655
15/03/2012;17;TO;30606725;8852905;21753820
15/04/2012;12;AC;1459246;485102;974144
15/04/2012;27;AL;142450259;46019416;96430843
15/04/2012;16;AP;42260629;13146375;29114254
15/04/2012;13;AM;70699984;950128812;-879428828
15/04/2012;29;BA;748116761;705975321;42141440
15/04/2012;23;CE;83688742;113922486;-30233744
15/04/2012;53;DF;21233376;106451024;-85217648
15/04/2012;32;ES;940970335;609053983;331916352
15/04/2012;52;GO;583534309;429744651;153789658
15/04/2012;21;MA;318905810;582255821;-263350011
15/04/2012;51;MT;1100186139;105199297;994986842
15/04/2012;50;MS;355926622;474837950;-118911328
15/04/2012;31;MG;2594886947;941267078;1653619869
15/04/2012;15;PA;1163081150;123652254;1039428896
15/04/2012;25;PB;12409967;42093031;-29683064
15/04/2012;41;PR;1444373742;1588558985;-144185243
15/04/2012;26;PE;53863622;731059045;-677195423
15/04/2012;22;PI;12659199;10642218;2016981
15/04/2012;33;RJ;3147935306;1745393148;1402542158
15/04/2012;24;RN;14420881;15926805;-1505924
15/04/2012;43;RS;1296365373;1412052888;-115687515
15/04/2012;11;RO;111055495;31324775;79730720
15/04/2012;14;RR;811715;981228;-169513
15/04/2012;42;SC;741663309;1106323991;-364660682
15/04/2012;35;SP;4001134441;6784157887;-2783023446
15/04/2012;28;SE;21800261;22455833;-655572
15/04/2012;17;TO;69848255;6022783;63825472
15/05/2012;12;AC;774614;382969;391645
15/05/2012;27;AL;48589989;24480340;24109649
15/05/2012;16;AP;42864971;11457217;31407754
15/05/2012;13;AM;86948335;1267754970;-1180806635
15/05/2012;29;BA;890887031;701672135;189214896
15/05/2012;23;CE;102082266;199658019;-97575753
15/05/2012;53;DF;19911982;97961684;-78049702
15/05/2012;32;ES;1100406797;739044905;361361892
15/05/2012;52;GO;844606325;530732843;313873482
15/05/2012;21;MA;285610754;574461509;-288850755
15/05/2012;51;MT;1969272948;106321127;1862951821
15/05/2012;50;MS;484783501;442905477;41878024
15/05/2012;31;MG;3007593862;942055075;2065538787
15/05/2012;15;PA;1158173874;126211603;1031962271
15/05/2012;25;PB;18888591;62423456;-43534865
15/05/2012;41;PR;2015481510;1782665123;232816387
15/05/2012;26;PE;74747139;524447978;-449700839
15/05/2012;22;PI;34733540;4367694;30365846
15/05/2012;33;RJ;2310543943;1873803021;436740922
15/05/2012;24;RN;18080237;22118803;-4038566
15/05/2012;43;RS;1677025908;1532015496;145010412
15/05/2012;11;RO;99894092;46734889;53159203
15/05/2012;14;RR;1357632;496917;860715
15/05/2012;42;SC;945624665;1285991716;-340367051
15/05/2012;35;SP;5468993491;7335642832;-1866649341
15/05/2012;28;SE;7645981;19057654;-11411673
15/05/2012;17;TO;109571722;9253890;100317832
15/06/2012;12;AC;450844;146913;303931
15/06/2012;27;AL;16025840;30355850;-14330010
15/06/2012;16;AP;31574568;10229688;21344880
15/06/2012;13;AM;73631175;1082508503;-1008877328
15/06/2012;29;BA;919786972;559453371;360333601
15/06/2012;23;CE;99564575;232486784;-132922209
15/06/2012;53;DF;21232029;106731629;-85499600
15/06/2012;32;ES;956266265;750584913;205681352
15/06/2012;52;GO;587300325;412628412;174671913
15/06/2012;21;MA;236318656;674594281;-438275625
15/06/2012;51;MT;1209290352;133947753;1075342599
15/06/2012;50;MS;312136257;483226103;-171089846
15/06/2012;31;MG;2734013598;883149274;1850864324
15/06/2012;15;PA;1152469829;76101844;1076367985
15/06/2012;25;PB;13428424;39291216;-25862792
15/06/2012;41;PR;1522492207;1537492488;-15000281
15/06/2012;26;PE;46137529;430611591;-384474062
15/06/2012;22;PI;18623447;12755397;5868050
15/06/2012;33;RJ;1418859146;2150712221;-731853075
15/06/2012;24;RN;13104178;19910914;-6806736
15/06/2012;43;RS;1724454924;1237031429;487423495
15/06/2012;11;RO;60501589;74348692;-13847103
15/06/2012;14;RR;2143710;457850;1685860
15/06/2012;42;SC;761061420;1071805441;-310744021
15/06/2012;35;SP;4858705439;6517308377;-1658602938
15/06/2012;28;SE;8358332;21909063;-13550731
15/06/2012;17;TO;60970898;5841959;55128939
15/07/2012;12;AC;736245;62307;673938
15/07/2012;27;AL;2188236;25831586;-23643350
15/07/2012;16;AP;37192661;5604163;31588498
15/07/2012;13;AM;70556586;1397988179;-1327431593
15/07/2012;29;BA;1077251230;576673984;500577246
15/07/2012;23;CE;89751165;211108831;-121357666
15/07/2012;53;DF;18522460;72836818;-54314358
15/07/2012;32;ES;822277986;686438147;135839839
15/07/2012;52;GO;734643176;401459022;333184154
15/07/2012;21;MA;297758683;404088452;-106329769
15/07/2012;51;MT;1184299023;108902024;1075396999
15/07/2012;50;MS;366518937;386221720;-19702783
15/07/2012;31;MG;2979325755;1219139752;1760186003
15/07/2012;15;PA;1259961535;112915071;1147046464
15/07/2012;25;PB;11914175;54538027;-42623852
15/07/2012;41;PR;1486602767;1540132747;-53529980
15/07/2012;26;PE;58524656;368441780;-309917124
15/07/2012;22;PI;28682953;25327478;3355475
15/07/2012;33;RJ;1948165586;2132583286;-184417700
15/07/2012;24;RN;15875119;22454559;-6579440
15/07/2012;43;RS;1766607332;1061489998;705117334
15/07/2012;11;RO;88991240;45544742;43446498
15/07/2012;14;RR;1334193;385603;948590
15/07/2012;42;SC;742461757;1146215515;-403753758
15/07/2012;35;SP;5275035295;6107591907;-832556612
15/07/2012;28;SE;8382254;18881132;-10498878
15/07/2012;17;TO;59267653;6326704;52940949
15/08/2012;12;AC;494219;169726;324493
15/08/2012;27;AL;1015862;31952479;-30936617
15/08/2012;16;AP;34338069;7640974;26697095
15/08/2012;13;AM;90701352;1394024060;-1303322708
15/08/2012;29;BA;1027952608;676445776;351506832
15/08/2012;23;CE;108874633;267467859;-158593226
15/08/2012;53;DF;24005184;101197498;-77192314
15/08/2012;32;ES;1015130838;792467918;222662920
15/08/2012;52;GO;596326256;486970283;109355973
15/08/2012;21;MA;206697572;282258199;-75560627
15/08/2012;51;MT;1072008998;173450622;898558376
15/08/2012;50;MS;336622684;391696128;-55073444
15/08/2012;31;MG;3082759319;1049750097;2033009222
15/08/2012;15;PA;1156612211;96007372;1060604839
15/08/2012;25;PB;6783119;57051532;-50268413
15/08/2012;41;PR;1604007314;1868792790;-264785476
15/08/2012;26;PE;54676219;461388960;-406712741
15/08/2012;22;PI;23986133;16737738;7248395
15/08/2012;33;RJ;2864787576;1661445167;1203342409
15/08/2012;24;RN;12060145;14408290;-2348145
15/08/2012;43;RS;1828929561;1371576993;457352568
15/08/2012;11;RO;67017327;52430452;14586875
15/08/2012;14;RR;736331;124615;611716
15/08/2012;42;SC;812600094;1333600263;-521000169
15/08/2012;35;SP;5807764597;6544076202;-736311605
15/08/2012;28;SE;12304102;11532193;771909
15/08/2012;17;TO;55011366;14529882;40481484
15/09/2012;12;AC;632090;2416101;-1784011
15/09/2012;27;AL;1530421;23139948;-21609527
15/09/2012;16;AP;24945617;8231802;16713815
15/09/2012;13;AM;67458542;1311889313;-1244430771
15/09/2012;29;BA;859482102;534355064;325127038
15/09/2012;23;CE;110807863;217843212;-107035349
15/09/2012;53;DF;24170251;66230603;-42060352
15/09/2012;32;ES;742357917;628653523;113704394
15/09/2012;52;GO;703009088;411245206;291763882
15/09/2012;21;MA;371127997;393034108;-21906111
15/09/2012;51;MT;1018924899;135493005;883431894
15/09/2012;50;MS;376133785;344650899;31482886
15/09/2012;31;MG;2662853399;981372676;1681480723
15/09/2012;15;PA;1339663156;110603195;1229059961
15/09/2012;25;PB;20314257;46178334;-25864077
15/09/2012;41;PR;1394886466;1505124805;-110238339
15/09/2012;26;PE;65753650;341546882;-275793232
15/09/2012;22;PI;29586100;17319736;12266364
15/09/2012;33;RJ;2112369690;1893087268;219282422
15/09/2012;24;RN;25341281;25326463;14818
15/09/2012;43;RS;1493795887;1283190643;210605244
15/09/2012;11;RO;57943890;46600093;11343797
15/09/2012;14;RR;702163;495234;206929
15/09/2012;42;SC;735446260;1128610453;-393164193
15/09/2012;35;SP;5260650980;5934625330;-673974350
15/09/2012;28;SE;14657696;53373527;-38715831
15/09/2012;17;TO;106257496;7913207;98344289
15/10/2012;12;AC;482513;172619;309894
15/10/2012;27;AL;84212177;35754185;48457992
15/10/2012;16;AP;40659324;11576801;29082523
15/10/2012;13;AM;114116380;1227869431;-1113753051
15/10/2012;29;BA;949506334;854003013;95503321
15/10/2012;23;CE;120883479;404358100;-283474621
15/10/2012;53;DF;19547245;115795953;-96248708
15/10/2012;32;ES;908659945;675182275;233477670
15/10/2012;52;GO;669481990;445110151;224371839
15/10/2012;21;MA;370156019;734202529;-364046510
15/10/2012;51;MT;1273221572;168223329;1104998243
15/10/2012;50;MS;459724109;483227207;-23503098
15/10/2012;31;MG;2894438958;1078566306;1815872652
15/10/2012;15;PA;1469398742;111237937;1358160805
15/10/2012;25;PB;31971203;60266683;-28295480
15/10/2012;41;PR;1795097140;1682060813;113036327
15/10/2012;26;PE;120804736;785094495;-664289759
15/10/2012;22;PI;36234578;21244195;14990383
15/10/2012;33;RJ;1545659600;1926811163;-381151563
15/10/2012;24;RN;27210252;19911471;7298781
15/10/2012;43;RS;1478797670;1359537156;119260514
15/10/2012;11;RO;68541012;69490170;-949158
15/10/2012;14;RR;4828316;430577;4397739
15/10/2012;42;SC;712742520;1353823293;-641080773
15/10/2012;35;SP;5594526484;6569371258;-974844774
15/10/2012;28;SE;14279821;27088529;-12808708
15/10/2012;17;TO;71993421;24516968;47476453
15/11/2012;12;AC;381640;202237;179403
15/11/2012;27;AL;130488523;40931348;89557175
15/11/2012;16;AP;29727946;7049119;22678827
15/11/2012;13;AM;98349673;967312788;-868963115
15/11/2012;29;BA;828330952;586538986;241791966
15/11/2012;23;CE;114527376;423258817;-308731441
15/11/2012;53;DF;19981171;104126576;-84145405
15/11/2012;32;ES;954189400;796572469;157616931
15/11/2012;52;GO;591347434;443363485;147983949
15/11/2012;21;MA;126431728;1259271312;-1132839584
15/11/2012;51;MT;1225626541;193046850;1032579691
15/11/2012;50;MS;367687770;489887743;-122199973
15/11/2012;31;MG;2782336308;1106033492;1676302816
15/11/2012;15;PA;1408622840;108311423;1300311417
15/11/2012;25;PB;17567757;59754257;-42186500
15/11/2012;41;PR;1296817658;1889696341;-592878683
15/11/2012;26;PE;90226141;935717107;-845490966
15/11/2012;22;PI;8595918;20477547;-11881629
15/11/2012;33;RJ;2230694085;1793653009;437041076
15/11/2012;24;RN;34725896;22434345;12291551
15/11/2012;43;RS;1183954272;1069330096;114624176
15/11/2012;11;RO;49465605;68728466;-19262861
15/11/2012;14;RR;652355;547828;104527
15/11/2012;42;SC;650517574;1232895967;-582378393
15/11/2012;35;SP;5029901375;7031953277;-2002051902
15/11/2012;28;SE;12706628;14038102;-1331474
15/11/2012;17;TO;24122903;8377641;15745262
15/12/2012;12;AC;618596;224810;393786
15/12/2012;27;AL;97235750;47915430;49320320
15/12/2012;16;AP;30803439;13250164;17553275
15/12/2012;13;AM;86074426;647857587;-561783161
15/12/2012;29;BA;969113718;734989055;234124663
15/12/2012;23;CE;106501648;197760548;-91258900
15/12/2012;53;DF;13034936;100591893;-87556957
15/12/2012;32;ES;1270261357;673368867;596892490
15/12/2012;52;GO;570307016;379649680;190657336
15/12/2012;21;MA;199258194;296754571;-97496377
15/12/2012;51;MT;968228093;164025719;804202374
15/12/2012;50;MS;319502848;592446568;-272943720
15/12/2012;31;MG;2623017763;1026305199;1596712564
15/12/2012;15;PA;1451206777;108222184;1342984593
15/12/2012;25;PB;29952824;34840084;-4887260
15/12/2012;41;PR;1239938317;1443026771;-203088454
15/12/2012;26;PE;108264564;566325314;-458060750
15/12/2012;22;PI;9772548;19720911;-9948363
15/12/2012;33;RJ;2538989295;1581362913;957626382
15/12/2012;24;RN;24150348;10779973;13370375
15/12/2012;43;RS;1095495656;2083233890;-987738234
15/12/2012;11;RO;63323940;60317526;3006414
15/12/2012;14;RR;253054;620054;-367000
15/12/2012;42;SC;681423160;1147554531;-466131371
15/12/2012;35;SP;4879274683;5533005805;-653731122
15/12/2012;28;SE;12360913;25035817;-12674904
15/12/2012;17;TO;25462941;21623177;3839764
15/01/2013;12;AC;1279786;180413;1099373
15/01/2013;27;AL;177006894;44258664;132748230
15/01/2013;16;AP;41499575;6572872;34926703
15/01/2013;13;AM;78152965;1068520902;-990367937
15/01/2013;29;BA;674819624;583241391;91578233
15/01/2013;23;CE;105324514;213313111;-107988597
15/01/2013;53;DF;22372832;101237472;-78864640
15/01/2013;32;ES;950456834;604330528;346126306
15/01/2013;52;GO;458367277;435871454;22495823
15/01/2013;21;MA;173325757;1241458349;-1068132592
15/01/2013;51;MT;1015764628;87943685;927820943
15/01/2013;50;MS;320996170;563075714;-242079544
15/01/2013;31;MG;2610442597;1006979259;1603463338
15/01/2013;15;PA;1242650136;101781324;1140868812
15/01/2013;25;PB;22000778;52582772;-30581994
15/01/2013;41;PR;955980085;1470078082;-514097997
15/01/2013;26;PE;93802505;977992311;-884189806
15/01/2013;22;PI;8679256;8886127;-206871
15/01/2013;33;RJ;768909387;2113250133;-1344340746
15/01/2013;24;RN;23412216;26606425;-3194209
15/01/2013;43;RS;1023165219;770349488;252815731
15/01/2013;11;RO;62794285;54904560;7889725
15/01/2013;14;RR;222337;276700;-54363
15/01/2013;42;SC;558910445;1158760663;-599850218
15/01/2013;35;SP;4050179898;7293076459;-3242896561
15/01/2013;28;SE;7478360;13595390;-6117030
15/01/2013;17;TO;23742477;13869368;9873109
15/02/2013;12;AC;1730341;168343;1561998
15/02/2013;27;AL;133530361;26590665;106939696
15/02/2013;16;AP;40638270;3120853;37517417
15/02/2013;13;AM;74816004;903676881;-828860877
15/02/2013;29;BA;657106856;360842870;296263986
15/02/2013;23;CE;90650952;312182339;-221531387
15/02/2013;53;DF;26030838;53812845;-27782007
15/02/2013;32;ES;698233631;531757362;166476269
15/02/2013;52;GO;410349017;332731130;77617887
15/02/2013;21;MA;126611985;597827834;-471215849
15/02/2013;51;MT;1086022604;172070036;913952568
15/02/2013;50;MS;349239522;484749550;-135510028
15/02/2013;31;MG;2235317179;825947830;1409369349
15/02/2013;15;PA;1061039642;61864257;999175385
15/02/2013;25;PB;19246062;60787690;-41541628
15/02/2013;41;PR;1071613190;1277093474;-205480284
15/02/2013;26;PE;76478017;683104695;-606626678
15/02/2013;22;PI;6050266;25221664;-19171398
15/02/2013;33;RJ;1506883635;1687676110;-180792475
15/02/2013;24;RN;26714884;16774769;9940115
15/02/2013;43;RS;1077907256;1644602703;-566695447
15/02/2013;11;RO;54239042;62876360;-8637318
15/02/2013;14;RR;438139;739336;-301197
15/02/2013;42;SC;589032706;1008603567;-419570861
15/02/2013;35;SP;3783995194;5666986387;-1882991193
15/02/2013;28;SE;6732063;11784840;-5052777
15/02/2013;17;TO;13105049;20834143;-7729094
15/03/2013;12;AC;1834918;86120;1748798
15/03/2013;27;AL;106644731;31954046;74690685
15/03/2013;16;AP;32896335;7098099;25798236
15/03/2013;13;AM;85537306;1064504299;-978966993
15/03/2013;29;BA;686701116;866906407;-180205291
15/03/2013;23;CE;79481379;280038466;-200557087
15/03/2013;53;DF;19495152;82179118;-62683966
15/03/2013;32;ES;844454984;578096405;266358579
15/03/2013;52;GO;567964315;485746629;82217686
15/03/2013;21;MA;145683324;743903686;-598220362
15/03/2013;51;MT;1366944672;227544352;1139400320
15/03/2013;50;MS;444448440;497950843;-53502403
15/03/2013;31;MG;2551040606;932332572;1618708034
15/03/2013;15;PA;1194761616;117957947;1076803669
15/03/2013;25;PB;24382266;68600381;-44218115
15/03/2013;41;PR;1377592435;1705236366;-327643931
15/03/2013;26;PE;44003532;507680494;-463676962
15/03/2013;22;PI;5697549;11077376;-5379827
15/03/2013;33;RJ;1814806538;1897214846;-82408308
15/03/2013;24;RN;17976133;17723330;252803
15/03/2013;43;RS;1402163462;1214774487;187388975
15/03/2013;11;RO;85001511;69675525;15325986
15/03/2013;14;RR;1174813;299334;875479
15/03/2013;42;SC;660759870;1166058781;-505298911
15/03/2013;35;SP;4461824143;6516584392;-2054760249
15/03/2013;28;SE;10297307;27657159;-17359852
15/03/2013;17;TO;36550105;18684834;17865271
15/04/2013;12;AC;1292036;198590;1093446
15/04/2013;27;AL;127256815;31023269;96233546
15/04/2013;16;AP;36273232;7810730;28462502
15/04/2013;13;AM;97485356;1187498655;-1090013299
15/04/2013;29;BA;984254567;678742799;305511768
15/04/2013;23;CE;82898962;193682869;-110783907
15/04/2013;53;DF;28758385;154505035;-125746650
15/04/2013;32;ES;879421139;643573522;235847617
15/04/2013;52;GO;705390522;470172031;235218491
15/04/2013;21;MA;284417058;445383627;-160966569
15/04/2013;51;MT;1913396033;196139610;1717256423
15/04/2013;50;MS;561120185;480167812;80952373
15/04/2013;31;MG;2877034333;1145102967;1731931366
15/04/2013;15;PA;1187572507;126767490;1060805017
15/04/2013;25;PB;14489569;57824245;-43334676
15/04/2013;41;PR;1578572785;1737530029;-158957244
15/04/2013;26;PE;66272781;319333375;-253060594
15/04/2013;22;PI;10581335;15389689;-4808354
15/04/2013;33;RJ;1258545621;1657025757;-398480136
15/04/2013;24;RN;15257379;37634977;-22377598
15/04/2013;43;RS;1728050580;1313146979;414903601
15/04/2013;11;RO;100265233;49056969;51208264
15/04/2013;14;RR;537993;1531410;-993417
15/04/2013;42;SC;801841795;1172168453;-370326658
15/04/2013;35;SP;4777213608;9474685945;-4697472337
15/04/2013;28;SE;7339067;22710085;-15371018
15/04/2013;17;TO;95211260;8813877;86397383
15/05/2013;12;AC;1036287;218031;818256
15/05/2013;27;AL;54085250;36107677;17977573
15/05/2013;16;AP;16523022;4874861;11648161
15/05/2013;13;AM;91930026;1249628019;-1157697993
15/05/2013;29;BA;895490588;725981025;169509563
15/05/2013;23;CE;101005952;422371592;-321365640
15/05/2013;53;DF;17745165;117925763;-100180598
15/05/2013;32;ES;769252878;568136065;201116813
15/05/2013;52;GO;792458607;459344924;333113683
15/05/2013;21;MA;218218007;720568794;-502350787
15/05/2013;51;MT;1635584359;168103887;1467480472
15/05/2013;50;MS;549247330;455485755;93761575
15/05/2013;31;MG;3094090641;1063138340;2030952301
15/05/2013;15;PA;1263478100;125639108;1137838992
15/05/2013;25;PB;11071292;55184578;-44113286
15/05/2013;41;PR;1811403861;1636571080;174832781
15/05/2013;26;PE;47999648;497251633;-449251985
15/05/2013;22;PI;23813462;7066784;16746678
15/05/2013;33;RJ;1739574915;2255604867;-516029952
15/05/2013;24;RN;11974398;20479075;-8504677
15/05/2013;43;RS;2263040277;1589906726;673133551
15/05/2013;11;RO;75649183;45893068;29756115
15/05/2013;14;RR;458696;691703;-233007
15/05/2013;42;SC;976939230;1238440475;-261501245
15/05/2013;35;SP;4724168893;7532366007;-2808197114
15/05/2013;28;SE;6208340;41241889;-35033549
15/05/2013;17;TO;100735428;9999088;90736340
15/06/2013;12;AC;716024;414128;301896
15/06/2013;27;AL;533311;32303667;-31770356
15/06/2013;16;AP;39737267;6370721;33366546
15/06/2013;13;AM;65973280;1205103193;-1139129913
15/06/2013;29;BA;768588698;763657131;4931567
15/06/2013;23;CE;82494757;326034719;-243539962
15/06/2013;53;DF;31972001;203576400;-171604399
15/06/2013;32;ES;813388841;537487945;275900896
15/06/2013;52;GO;566199676;407829864;158369812
15/06/2013;21;MA;220113537;459031872;-238918335
15/06/2013;51;MT;1509453848;171320105;1338133743
15/06/2013;50;MS;483575301;450912544;32662757
15/06/2013;31;MG;2642312271;1030259681;1612052590
15/06/2013;15;PA;1281208719;82856393;1198352326
15/06/2013;25;PB;13808257;42606429;-28798172
15/06/2013;41;PR;1698288975;1620767683;77521292
15/06/2013;26;PE;40921509;319110969;-278189460
15/06/2013;22;PI;17054621;10505532;6549089
15/06/2013;33;RJ;1195709032;1722960807;-527251775
15/06/2013;24;RN;12214422;12259375;-44953
15/06/2013;43;RS;1990067988;1356110542;633957446
15/06/2013;11;RO;72171496;41453471;30718025
15/06/2013;14;RR;1014583;416372;598211
15/06/2013;42;SC;819261714;1058762260;-239500546
15/06/2013;35;SP;4463455656;6912700167;-2449244511
15/06/2013;28;SE;6231950;41794770;-35562820
15/06/2013;17;TO;68320485;14125466;54195019
15/07/2013;12;AC;593787;34428;559359
15/07/2013;27;AL;422378;34599758;-34177380
15/07/2013;16;AP;20994452;5770607;15223845
15/07/2013;13;AM;84707362;1361348770;-1276641408
15/07/2013;29;BA;974338201;660304547;314033654
15/07/2013;23;CE;97872180;250562245;-152690065
15/07/2013;53;DF;29393189;130239680;-100846491
15/07/2013;32;ES;821546807;669909422;151637385
15/07/2013;52;GO;669238438;369980681;299257757
15/07/2013;21;MA;235879249;360227500;-124348251
15/07/2013;51;MT;1529924206;106983131;1422941075
15/07/2013;50;MS;523526126;476068367;47457759
15/07/2013;31;MG;2895850430;1124506011;1771344419
15/07/2013;15;PA;1208008769;84673244;1123335525
15/07/2013;25;PB;11375627;51926461;-40550834
15/07/2013;41;PR;1732388305;1581290033;151098272
15/07/2013;26;PE;53904601;559723899;-505819298
15/07/2013;22;PI;9574408;15716178;-6141770
15/07/2013;33;RJ;1296871304;2222754488;-925883184
15/07/2013;24;RN;12620477;25917080;-13296603
15/07/2013;43;RS;1872241194;1631855207;240385987
15/07/2013;11;RO;131289468;45844193;85445275
15/07/2013;14;RR;1679177;623894;1055283
15/07/2013;42;SC;796761580;1361534541;-564772961
15/07/2013;35;SP;4885222161;9538629557;-4653407396
15/07/2013;28;SE;7887241;25437844;-17550603
15/07/2013;17;TO;76676500;16492312;60184188
15/08/2013;12;AC;819097;217847;601250
15/08/2013;27;AL;414734;39382506;-38967772
15/08/2013;16;AP;29930592;4222505;25708087
15/08/2013;13;AM;78626845;1309628046;-1231001201
15/08/2013;29;BA;741812319;766333461;-24521142
15/08/2013;23;CE;105516969;173880704;-68363735
15/08/2013;53;DF;20909407;88981624;-68072217
15/08/2013;32;ES;860756807;627904795;232852012
15/08/2013;52;GO;692899885;429430115;263469770
15/08/2013;21;MA;194682695;205071958;-10389263
15/08/2013;51;MT;1417947861;167974065;1249973796
15/08/2013;50;MS;462273420;503604403;-41330983
15/08/2013;31;MG;2824473261;1066804103;1757669158
15/08/2013;15;PA;1135449518;80163089;1055286429
15/08/2013;25;PB;5368450;53132250;-47763800
15/08/2013;41;PR;1919610309;2089409686;-169799377
15/08/2013;26;PE;56936278;732453773;-675517495
15/08/2013;22;PI;18799317;15774522;3024795
15/08/2013;33;RJ;1672713515;1527650553;145062962
15/08/2013;24;RN;13981089;41238965;-27257876
15/08/2013;43;RS;2364494082;1630957759;733536323
15/08/2013;11;RO;111847284;53053136;58794148
15/08/2013;14;RR;547970;663123;-115153
15/08/2013;42;SC;712683093;1290927530;-578244437
15/08/2013;35;SP;5288635223;7264461393;-1975826170
15/08/2013;28;SE;5375441;32140009;-26764568
15/08/2013;17;TO;74077806;13207622;60870184
15/09/2013;12;AC;321103;120859;200244
15/09/2013;27;AL;1868452;38529146;-36660694
15/09/2013;16;AP;37390578;6412289;30978289
15/09/2013;13;AM;91108970;1399567089;-1308458119
15/09/2013;29;BA;1009944534;767394147;242550387
15/09/2013;23;CE;156215973;334077626;-177861653
15/09/2013;53;DF;15756175;64893058;-49136883
15/09/2013;32;ES;894351824;534023477;360328347
15/09/2013;52;GO;623593572;341111372;282482200
15/09/2013;21;MA;213093215;398962688;-185869473
15/09/2013;51;MT;1303268681;143943349;1159325332
15/09/2013;50;MS;482641696;435174512;47467184
15/09/2013;31;MG;2799618178;1023449900;1776168278
15/09/2013;15;PA;1406471938;67477498;1338994440
15/09/2013;25;PB;8432087;50884152;-42452065
15/09/2013;41;PR;1665089815;1521930442;143159373
15/09/2013;26;PE;90115880;551710187;-461594307
15/09/2013;22;PI;27467249;25137202;2330047
15/09/2013;33;RJ;1962805099;1434764461;528040638
15/09/2013;24;RN;24407150;14099550;10307600
15/09/2013;43;RS;2109047903;1465915294;643132609
15/09/2013;11;RO;104692759;45904743;58788016
15/09/2013;14;RR;382821;1173150;-790329
15/09/2013;42;SC;619963611;1143018235;-523054624
15/09/2013;35;SP;4660002906;7043808733;-2383805827
15/09/2013;28;SE;5861908;12629720;-6767812
15/09/2013;17;TO;81603490;14736021;66867469
15/10/2013;12;AC;732674;203899;528775
15/10/2013;27;AL;15702258;58376976;-42674718
15/10/2013;16;AP;13809334;7919364;5889970
15/10/2013;13;AM;110582608;1535457510;-1424874902
15/10/2013;29;BA;714481521;1018756217;-304274696
15/10/2013;23;CE;174311338;360620617;-186309279
15/10/2013;53;DF;16616126;127846429;-111230303
15/10/2013;32;ES;856389823;760968097;95421726
15/10/2013;52;GO;556848333;333319210;223529123
15/10/2013;21;MA;219579675;620315024;-400735349
15/10/2013;51;MT;1010207740;82600188;927607552
15/10/2013;50;MS;434187147;447701151;-13514004
15/10/2013;31;MG;3395300398;1174844628;2220455770
15/10/2013;15;PA;1517474744;95701865;1421772879
15/10/2013;25;PB;17862892;57177552;-39314660
15/10/2013;41;PR;1686481879;1772701523;-86219644
15/10/2013;26;PE;84968536;585312593;-500344057
15/10/2013;22;PI;9490303;16740807;-7250504
15/10/2013;33;RJ;1574732614;1503418695;71313919
15/10/2013;24;RN;31192683;23228132;7964551
15/10/2013;43;RS;1875147196;1505798745;369348451
15/10/2013;11;RO;74048602;62682622;11365980
15/10/2013;14;RR;333223;507886;-174663
15/10/2013;42;SC;741493345;1622582073;-881088728
15/10/2013;35;SP;5061391587;9236312344;-4174920757
15/10/2013;28;SE;5172676;22998151;-17825475
15/10/2013;17;TO;60472586;16328777;44143809
15/11/2013;12;AC;538482;204975;333507
15/11/2013;27;AL;19465176;47643103;-28177927
15/11/2013;16;AP;68154314;18043965;50110349
15/11/2013;13;AM;95029313;1108528486;-1013499173
15/11/2013;29;BA;799221746;787001020;12220726
15/11/2013;23;CE;103906116;219870371;-115964255
15/11/2013;53;DF;15641348;129098773;-113457425
15/11/2013;32;ES;888000565;592163356;295837209
15/11/2013;52;GO;531313990;366969582;164344408
15/11/2013;21;MA;151016927;299164243;-148147316
15/11/2013;51;MT;1100992011;98727485;1002264526
15/11/2013;50;MS;307263862;490060244;-182796382
15/11/2013;31;MG;2814685546;1085434996;1729250550
15/11/2013;15;PA;1466939375;92292255;1374647120
15/11/2013;25;PB;20245005;44995875;-24750870
15/11/2013;41;PR;1397837630;1450636817;-52799187
15/11/2013;26;PE;99218593;664898958;-565680365
15/11/2013;22;PI;17995347;22344320;-4348973
15/11/2013;33;RJ;1878518884;2114698994;-236180110
15/11/2013;24;RN;31451241;16445121;15006120
15/11/2013;43;RS;1400864585;1152902242;247962343
15/11/2013;11;RO;82665725;42863118;39802607
15/11/2013;14;RR;789367;257534;531833
15/11/2013;42;SC;678138674;1349627633;-671488959
15/11/2013;35;SP;4567842681;6902643683;-2334801002
15/11/2013;28;SE;7655482;13365859;-5710377
15/11/2013;17;TO;49144667;21333999;27810668
15/12/2013;12;AC;479491;84498;394993
15/12/2013;27;AL;104989081;76342446;28646635
15/12/2013;16;AP;38300056;11665850;26634206
15/12/2013;13;AM;73776521;901391730;-827615209
15/12/2013;29;BA;749366899;850084668;-100717769
15/12/2013;23;CE;239867754;220423957;19443797
15/12/2013;53;DF;16334910;99996858;-83661948
15/12/2013;32;ES;1159645565;739471530;420174035
15/12/2013;52;GO;462820076;412460481;50359595
15/12/2013;21;MA;159285516;742094282;-582808766
15/12/2013;51;MT;922203749;114869486;807334263
15/12/2013;50;MS;306355480;473017824;-166662344
15/12/2013;31;MG;2640809267;851228124;1789581143
15/12/2013;15;PA;1886429195;81472289;1804956906
15/12/2013;25;PB;19353079;45874095;-26521016
15/12/2013;41;PR;1202848603;1564475754;-361627151
15/12/2013;26;PE;79980969;428572632;-348591663
15/12/2013;22;PI;6581491;23781171;-17199680
15/12/2013;33;RJ;2374594118;1487136325;887457793
15/12/2013;24;RN;26416031;13863060;12552971
15/12/2013;43;RS;1157457407;1425210606;-267753199
15/12/2013;11;RO;84694306;42792120;41902186
15/12/2013;14;RR;409545;906189;-496644
15/12/2013;42;SC;704483511;1152099761;-447616250
15/12/2013;35;SP;4698950785;6407098308;-1708147523
15/12/2013;28;SE;8332424;21996237;-13663813
15/12/2013;17;TO;22481954;16462073;6019881
15/01/2014;12;AC;606650;394424;212226
15/01/2014;27;AL;78719693;52946331;25773362
15/01/2014;16;AP;53679238;4205971;49473267
15/01/2014;13;AM;72203575;1346601201;-1274397626
15/01/2014;29;BA;680218128;758445920;-78227792
15/01/2014;23;CE;132604771;230732885;-98128114
15/01/2014;53;DF;17868953;92175427;-74306474
15/01/2014;32;ES;818227191;737088489;81138702
15/01/2014;52;GO;397143425;402716921;-5573496
15/01/2014;21;MA;124244864;622440259;-498195395
15/01/2014;51;MT;805068864;117678894;687389970
15/01/2014;50;MS;267440651;479382166;-211941515
15/01/2014;31;MG;2600120304;976383500;1623736804
15/01/2014;15;PA;1315454533;57635282;1257819251
15/01/2014;25;PB;11178737;75936151;-64757414
15/01/2014;41;PR;902137555;1213010736;-310873181
15/01/2014;26;PE;68664902;743559193;-674894291
15/01/2014;22;PI;5554269;26657064;-21102795
15/01/2014;33;RJ;1512199495;2149582180;-637382685
15/01/2014;24;RN;25393678;18469927;6923751
15/01/2014;43;RS;1077344620;721857007;355487613
15/01/2014;11;RO;61764093;50518250;11245843
15/01/2014;14;RR;8552543;710513;7842030
15/01/2014;42;SC;554284340;1439379399;-885095059
15/01/2014;35;SP;3783335117;7727172410;-3943837293
15/01/2014;28;SE;5759571;19681429;-13921858
15/01/2014;17;TO;20271439;30085003;-9813564
15/02/2014;12;AC;826675;421349;405326
15/02/2014;27;AL;101804933;37163438;64641495
15/02/2014;16;AP;50300790;48644856;1655934
15/02/2014;13;AM;78403644;1157234263;-1078830619
15/02/2014;29;BA;692738842;551928724;140810118
15/02/2014;23;CE;93188390;256085587;-162897197
15/02/2014;53;DF;20883385;101345957;-80462572
15/02/2014;32;ES;847987012;579114978;268872034
15/02/2014;52;GO;525714353;352485123;173229230
15/02/2014;21;MA;124927193;632266880;-507339687
15/02/2014;51;MT;991601894;102166061;889435833
15/02/2014;50;MS;345586958;451554282;-105967324
15/02/2014;31;MG;2294313089;854614193;1439698896
15/02/2014;15;PA;1246656692;57028814;1189627878
15/02/2014;25;PB;16966013;57506410;-40540397
15/02/2014;41;PR;1311179091;1306937756;4241335
15/02/2014;26;PE;69984915;644122276;-574137361
15/02/2014;22;PI;8477097;22184240;-13707143
15/02/2014;33;RJ;1102518609;1586672356;-484153747
15/02/2014;24;RN;18014320;11836753;6177567
15/02/2014;43;RS;1020722446;1542215022;-521492576
15/02/2014;11;RO;69829629;52143470;17686159
15/02/2014;14;RR;7274876;747154;6527722
15/02/2014;42;SC;675410740;1280049587;-604638847
15/02/2014;35;SP;3761118424;6304872593;-2543754169
15/02/2014;28;SE;6088880;19942020;-13853140
15/02/2014;17;TO;21203962;50046845;-28842883
15/03/2014;12;AC;883333;312194;571139
15/03/2014;27;AL;64037937;39957491;24080446
15/03/2014;16;AP;31711400;4896144;26815256
15/03/2014;13;AM;77045835;1084795800;-1007749965
15/03/2014;29;BA;623693097;770123990;-146430893
15/03/2014;23;CE;93465292;153110325;-59645033
15/03/2014;53;DF;35497228;116649266;-81152038
15/03/2014;32;ES;986754819;548823717;437931102
15/03/2014;52;GO;732643906;333600204;399043702
15/03/2014;21;MA;124649529;565141622;-440492093
15/03/2014;51;MT;1578757312;146320320;1432436992
15/03/2014;50;MS;534018434;386006756;148011678
15/03/2014;31;MG;2385689356;811874013;1573815343
15/03/2014;15;PA;1115518861;43968300;1071550561
15/03/2014;25;PB;14270909;42729723;-28458814
15/03/2014;41;PR;1466344150;1424405224;41938926
15/03/2014;26;PE;59393196;585536720;-526143524
15/03/2014;22;PI;6365776;13983439;-7617663
15/03/2014;33;RJ;1377593020;1349589958;28003062
15/03/2014;24;RN;20007191;13720471;6286720
15/03/2014;43;RS;1156097977;1116740120;39357857
15/03/2014;11;RO;73884044;53014072;20869972
15/03/2014;14;RR;225074;521776;-296702
15/03/2014;42;SC;671949218;1318602725;-646653507
15/03/2014;35;SP;3868522298;6528657469;-2660135171
15/03/2014;28;SE;8453606;13725987;-5272381
15/03/2014;17;TO;60918517;42190921;18727596
15/04/2014;12;AC;496721;2006976;-1510255
15/04/2014;27;AL;56232564;33640974;22591590
15/04/2014;16;AP;48156275;4263796;43892479
15/04/2014;13;AM;94147193;1109026393;-1014879200
15/04/2014;29;BA;755485008;559910706;195574302
15/04/2014;23;CE;82243041;204920555;-122677514
15/04/2014;53;DF;21387573;101252519;-79864946
15/04/2014;32;ES;850245106;586336989;263908117
15/04/2014;52;GO;684863744;368599638;316264106
15/04/2014;21;MA;268769815;534436147;-265666332
15/04/2014;51;MT;1950961193;166438265;1784522928
15/04/2014;50;MS;583207491;429474909;153732582
15/04/2014;31;MG;2400152138;922706731;1477445407
15/04/2014;15;PA;1181161291;129615875;1051545416
15/04/2014;25;PB;18170893;44515712;-26344819
15/04/2014;41;PR;1663662181;1425001048;238661133
15/04/2014;26;PE;54339320;574188776;-519849456
15/04/2014;22;PI;11205018;28172455;-16967437
15/04/2014;33;RJ;1363737885;2366253298;-1002515413
15/04/2014;24;RN;14817534;18283911;-3466377
15/04/2014;43;RS;1660462083;1234789059;425673024
15/04/2014;11;RO;119047931;116427272;2620659
15/04/2014;14;RR;409259;990000;-580741
15/04/2014;42;SC;881636996;1240848705;-359211709
15/04/2014;35;SP;4365401513;6987874971;-2622473458
15/04/2014;28;SE;4915596;12840200;-7924604
15/04/2014;17;TO;69243624;10041655;59201969
15/05/2014;12;AC;537089;994081;-456992
15/05/2014;27;AL;64583912;59681488;4902424
15/05/2014;16;AP;31749034;2584072;29164962
15/05/2014;13;AM;71532543;1041391828;-969859285
15/05/2014;29;BA;925486237;989058754;-63572517
15/05/2014;23;CE;86275622;385058191;-298782569
15/05/2014;53;DF;32540597;135301585;-102760988
15/05/2014;32;ES;1034939483;632111585;402827898
15/05/2014;52;GO;703439895;378607089;324832806
15/05/2014;21;MA;194445167;429533398;-235088231
15/05/2014;51;MT;1745964257;241793901;1504170356
15/05/2014;50;MS;570357094;521474159;48882935
15/05/2014;31;MG;2666728823;872811545;1793917278
15/05/2014;15;PA;1303897578;100405668;1203491910
15/05/2014;25;PB;14059618;57769925;-43710307
15/05/2014;41;PR;1548660897;1650445262;-101784365
15/05/2014;26;PE;179637091;685898336;-506261245
15/05/2014;22;PI;28060570;34312857;-6252287
15/05/2014;33;RJ;1549867936;1684150252;-134282316
15/05/2014;24;RN;14417854;20001230;-5583376
15/05/2014;43;RS;1961677971;1383658779;578019192
15/05/2014;11;RO;106828895;50193535;56635360
15/05/2014;14;RR;523590;683426;-159836
15/05/2014;42;SC;841095871;1357132643;-516036772
15/05/2014;35;SP;4356798174;7287622476;-2930824302
15/05/2014;28;SE;8254510;26955833;-18701323
15/05/2014;17;TO;107009160;13193021;93816139
15/06/2014;12;AC;656426;475858;180568
15/06/2014;27;AL;16703644;31883548;-15179904
15/06/2014;16;AP;10986868;3710449;7276419
15/06/2014;13;AM;94586167;1003960306;-909374139
15/06/2014;29;BA;733698094;591140132;142557962
15/06/2014;23;CE;262968535;197717346;65251189
15/06/2014;53;DF;25402128;130697996;-105295868
15/06/2014;32;ES;838989757;533158847;305830910
15/06/2014;52;GO;618013753;304854089;313159664
15/06/2014;21;MA;279182455;651956473;-372774018
15/06/2014;51;MT;1591664232;139210629;1452453603
15/06/2014;50;MS;549274390;448615202;100659188
15/06/2014;31;MG;2647054439;849843437;1797211002
15/06/2014;15;PA;1261280940;88261233;1173019707
15/06/2014;25;PB;11955775;53067302;-41111527
15/06/2014;41;PR;1444858038;1311038244;133819794
15/06/2014;26;PE;79078869;495473820;-416394951
15/06/2014;22;PI;22558763;13737083;8821680
15/06/2014;33;RJ;1854417763;1827143043;27274720
15/06/2014;24;RN;13568174;10618429;2949745
15/06/2014;43;RS;2016777464;1259723889;757053575
15/06/2014;11;RO;144556149;38633058;105923091
15/06/2014;14;RR;439667;712253;-272586
15/06/2014;42;SC;849587868;1110704555;-261116687
15/06/2014;35;SP;4403113019;7000310287;-2597197268
15/06/2014;28;SE;6554647;15108529;-8553882
15/06/2014;17;TO;137875140;12453959;125421181
15/07/2014;12;AC;451253;1377605;-926352
15/07/2014;27;AL;36816257;41178412;-4362155
15/07/2014;16;AP;36368144;3999210;32368934
15/07/2014;13;AM;80251548;1221058583;-1140807035
15/07/2014;29;BA;887461321;1024097680;-136636359
15/07/2014;23;CE;124995455;538855537;-413860082
15/07/2014;53;DF;32315205;71860456;-39545251
15/07/2014;32;ES;1169922324;656863322;513059002
15/07/2014;52;GO;660024466;395994282;264030184
15/07/2014;21;MA;326379196;570414792;-244035596
15/07/2014;51;MT;1406800826;159634426;1247166400
15/07/2014;50;MS;492165548;434487227;57678321
15/07/2014;31;MG;2633402421;1017475402;1615927019
15/07/2014;15;PA;1143755691;77011700;1066743991
15/07/2014;25;PB;13113691;63792496;-50678805
15/07/2014;41;PR;1647580497;1917407544;-269827047
15/07/2014;26;PE;65463437;895501440;-830038003
15/07/2014;22;PI;41579909;22150643;19429266
15/07/2014;33;RJ;2866367595;1683442060;1182925535
15/07/2014;24;RN;17772325;67553764;-49781439
15/07/2014;43;RS;2020991537;1397033115;623958422
15/07/2014;11;RO;137271657;47174150;90097507
15/07/2014;14;RR;216490;622720;-406230
15/07/2014;42;SC;915918992;1470668346;-554749354
15/07/2014;35;SP;4618515007;7629116932;-3010601925
15/07/2014;28;SE;7200426;39090810;-31890384
15/07/2014;17;TO;153165174;13759787;139405387
15/08/2014;12;AC;673101;779941;-106840
15/08/2014;27;AL;5412211;52134568;-46722357
15/08/2014;16;AP;42565275;3706460;38858815
15/08/2014;13;AM;65388470;1082608513;-1017220043
15/08/2014;29;BA;806938082;738094659;68843423
15/08/2014;23;CE;149078981;228402609;-79323628
15/08/2014;53;DF;60248853;83784309;-23535456
15/08/2014;32;ES;918785428;498493860;420291568
15/08/2014;52;GO;646925944;460427964;186497980
15/08/2014;21;MA;272558694;415612559;-143053865
15/08/2014;51;MT;1406129607;188146038;1217983569
15/08/2014;50;MS;483199434;451321500;31877934
15/08/2014;31;MG;2352915431;867112337;1485803094
15/08/2014;15;PA;1108566353;83822315;1024744038
15/08/2014;25;PB;13630090;67739578;-54109488
15/08/2014;41;PR;1500259246;1423274917;76984329
15/08/2014;26;PE;51913192;457260677;-405347485
15/08/2014;22;PI;57662306;27031899;30630407
15/08/2014;33;RJ;1764902335;2108488368;-343586033
15/08/2014;24;RN;14996409;19809947;-4813538
15/08/2014;43;RS;1754448497;1292614144;461834353
15/08/2014;11;RO;112214296;41765779;70448517
15/08/2014;14;RR;218335;978248;-759913
15/08/2014;42;SC;785764267;1289014575;-503250308
15/08/2014;35;SP;4274506515;7384484179;-3109977664
15/08/2014;28;SE;5865258;23690140;-17824882
15/08/2014;17;TO;134272123;11144727;123127396
15/09/2014;12;AC;406074;691908;-285834
15/09/2014;27;AL;3636813;47983467;-44346654
15/09/2014;16;AP;44507008;4094901;40412107
15/09/2014;13;AM;83427416;1246535760;-1163108344
15/09/2014;29;BA;1033503897;699475125;334028772
15/09/2014;23;CE;118902369;291386090;-172483721
15/09/2014;53;DF;16624554;156084700;-139460146
15/09/2014;32;ES;1009744935;566480777;443264158
15/09/2014;52;GO;517904983;359769558;158135425
15/09/2014;21;MA;315724988;656651583;-340926595
15/09/2014;51;MT;835224507;146038721;689185786
15/09/2014;50;MS;365666187;467762138;-102095951
15/09/2014;31;MG;2608925532;911724712;1697200820
15/09/2014;15;PA;1208369251;100395001;1107974250
15/09/2014;25;PB;21251863;58348714;-37096851
15/09/2014;41;PR;1326112693;1616682102;-290569409
15/09/2014;26;PE;62183685;574263988;-512080303
15/09/2014;22;PI;37830939;21552649;16278290
15/09/2014;33;RJ;1768482086;1622083956;146398130
15/09/2014;24;RN;26526163;30072912;-3546749
15/09/2014;43;RS;2064508054;1329899576;734608478
15/09/2014;11;RO;53454856;41712415;11742441
15/09/2014;14;RR;306441;1237523;-931082
15/09/2014;42;SC;741912190;1429243726;-687331536
15/09/2014;35;SP;4604151399;8145871181;-3541719782
15/09/2014;28;SE;5464047;20113189;-14649142
15/09/2014;17;TO;71746502;14068448;57678054
15/10/2014;12;AC;644563;979533;-334970
15/10/2014;27;AL;28911238;55107939;-26196701
15/10/2014;16;AP;17941388;6990952;10950436
15/10/2014;13;AM;79524544;1199481095;-1119956551
15/10/2014;29;BA;744444029;835533701;-91089672
15/10/2014;23;CE;104946203;221293587;-116347384
15/10/2014;53;DF;30843823;125714374;-94870551
15/10/2014;32;ES;1192585557;593349101;599236456
15/10/2014;52;GO;567939230;388244640;179694590
15/10/2014;21;MA;332050826;615990886;-283940060
15/10/2014;51;MT;895902863;131148234;764754629
15/10/2014;50;MS;380662019;394902619;-14240600
15/10/2014;31;MG;2391256212;985611944;1405644268
15/10/2014;15;PA;1190874837;102778238;1088096599
15/10/2014;25;PB;13006343;63881164;-50874821
15/10/2014;41;PR;1241069705;1219885577;21184128
15/10/2014;26;PE;96163073;432590097;-336427024
15/10/2014;22;PI;22919479;11371295;11548184
15/10/2014;33;RJ;1442139808;2046399775;-604259967
15/10/2014;24;RN;27610002;23197192;4412810
15/10/2014;43;RS;1527216925;1152460412;374756513
15/10/2014;11;RO;68828338;58381141;10447197
15/10/2014;14;RR;380390;1203993;-823603
15/10/2014;42;SC;756989913;1537686027;-780696114
15/10/2014;35;SP;4486743174;7280000795;-2793257621
15/10/2014;28;SE;7533652;14579150;-7045498
15/10/2014;17;TO;40910407;10926518;29983889
15/11/2014;12;AC;672089;624713;47376
15/11/2014;27;AL;57512464;60788902;-3276438
15/11/2014;16;AP;21890484;5039923;16850561
15/11/2014;13;AM;66242982;888693213;-822450231
15/11/2014;29;BA;658639602;843731945;-185092343
15/11/2014;23;CE;93878707;164222424;-70343717
15/11/2014;53;DF;18409744;68767549;-50357805
15/11/2014;32;ES;1072334762;535942456;536392306
15/11/2014;52;GO;434999056;324651659;110347397
15/11/2014;21;MA;226443009;689658702;-463215693
15/11/2014;51;MT;766246431;151615907;614630524
15/11/2014;50;MS;303963280;391285585;-87322305
15/11/2014;31;MG;2051316401;1006597185;1044719216
15/11/2014;15;PA;943849261;69719154;874130107
15/11/2014;25;PB;13038537;30130980;-17092443
15/11/2014;41;PR;1169090219;1600302833;-431212614
15/11/2014;26;PE;71002798;683625583;-612622785
15/11/2014;22;PI;7138136;13129154;-5991018
15/11/2014;33;RJ;1560931433;1806038016;-245106583
15/11/2014;24;RN;29568463;54344008;-24775545
15/11/2014;43;RS;1047258088;1408330904;-361072816
15/11/2014;11;RO;51800607;49749646;2050961
15/11/2014;14;RR;337720;1015459;-677739
15/11/2014;42;SC;612897866;1350666769;-737768903
15/11/2014;35;SP;3876133279;5840250546;-1964117267
15/11/2014;28;SE;6349365;12638449;-6289084
15/11/2014;17;TO;21746511;16873623;4872888
15/12/2014;12;AC;362986;646568;-283582
15/12/2014;27;AL;114773020;71801857;42971163
15/12/2014;16;AP;35490787;9150396;26340391
15/12/2014;13;AM;61288676;754611426;-693322750
15/12/2014;29;BA;697969741;925753291;-227783550
15/12/2014;23;CE;127158889;141584859;-14425970
15/12/2014;53;DF;18075561;94647805;-76572244
15/12/2014;32;ES;1018484905;397198640;621286265
15/12/2014;52;GO;484056518;351489182;132567336
15/12/2014;21;MA;206112902;685883312;-479770410
15/12/2014;51;MT;794020942;104423729;689597213
15/12/2014;50;MS;339049819;383061647;-44011828
15/12/2014;31;MG;2265631582;924289298;1341342284
15/12/2014;15;PA;1236624404;66695915;1169928489
15/12/2014;25;PB;18436139;37695363;-19259224
15/12/2014;41;PR;1019957379;1220700887;-200743508
15/12/2014;26;PE;83293283;562513952;-479220669
15/12/2014;22;PI;6619373;12226639;-5607266
15/12/2014;33;RJ;1727420601;1448331491;279089110
15/12/2014;24;RN;28103149;26337081;1766068
15/12/2014;43;RS;1340453555;1041575103;298878452
15/12/2014;11;RO;67701330;43186644;24514686
15/12/2014;14;RR;324174;911008;-586834
15/12/2014;42;SC;675995539;1195611467;-519615928
15/12/2014;35;SP;4502509980;6666906257;-2164396277
15/12/2014;28;SE;5365993;11692403;-6326410
15/12/2014;17;TO;20977976;12460955;8517021
15/01/2015;12;AC;1404727;329292;1075435
15/01/2015;27;AL;50917623;59880209;-8962586
15/01/2015;16;AP;24617753;3580537;21037216
15/01/2015;13;AM;53277355;1045921142;-992643787
15/01/2015;29;BA;534093144;888006547;-353913403
15/01/2015;23;CE;99525495;647476631;-547951136
15/01/2015;53;DF;13297322;107561933;-94264611
15/01/2015;32;ES;857426678;530914673;326512005
15/01/2015;52;GO;401842684;246984520;154858164
15/01/2015;21;MA;242306269;752928998;-510622729
15/01/2015;51;MT;679949426;159997099;519952327
15/01/2015;50;MS;321837728;398968860;-77131132
15/01/2015;31;MG;1912893709;719083964;1193809745
15/01/2015;15;PA;923781415;93696560;830084855
15/01/2015;25;PB;9849100;51717558;-41868458
15/01/2015;41;PR;903842294;1060424841;-156582547
15/01/2015;26;PE;41348727;478990110;-437641383
15/01/2015;22;PI;5336962;20639716;-15302754
15/01/2015;33;RJ;1393650634;1729945584;-336294950
15/01/2015;24;RN;20054468;19764585;289883
15/01/2015;43;RS;965946917;701870564;264076353
15/01/2015;11;RO;40601050;56197309;-15596259
15/01/2015;14;RR;163406;649587;-486181
15/01/2015;42;SC;516747470;1401764971;-885017501
15/01/2015;35;SP;3107597679;5659044697;-2551447018
15/01/2015;28;SE;4488435;19133839;-14645404
15/01/2015;17;TO;19434332;14953038;4481294
15/02/2015;12;AC;1297202;808754;488448
15/02/2015;27;AL;62686913;52315690;10371223
15/02/2015;16;AP;40576929;2810894;37766035
15/02/2015;13;AM;54071754;853059082;-798987328
15/02/2015;29;BA;514762264;789456746;-274694482
15/02/2015;23;CE;74722199;148714715;-73992516
15/02/2015;53;DF;12214278;103023631;-90809353
15/02/2015;32;ES;708704078;405099766;303604312
15/02/2015;52;GO;301495474;249792095;51703379
15/02/2015;21;MA;153366084;474831301;-321465217
15/02/2015;51;MT;585357226;105042244;480314982
15/02/2015;50;MS;253931006;337786284;-83855278
15/02/2015;31;MG;1666551612;682490632;984060980
15/02/2015;15;PA;833328638;79009742;754318896
15/02/2015;25;PB;12436159;40831508;-28395349
15/02/2015;41;PR;846771437;1038663045;-191891608
15/02/2015;26;PE;47121373;404591714;-357470341
15/02/2015;22;PI;10735238;6799263;3935975
15/02/2015;33;RJ;919499285;1165476103;-245976818
15/02/2015;24;RN;16597639;11746953;4850686
15/02/2015;43;RS;874176104;823654615;50521489
15/02/2015;11;RO;61458391;41249617;20208774
15/02/2015;14;RR;226097;1284631;-1058534
15/02/2015;42;SC;568306460;1216865699;-648559239
15/02/2015;35;SP;3062592511;5871147623;-2808555112
15/02/2015;28;SE;5119921;13066573;-7946652
15/02/2015;17;TO;12554879;14892651;-2337772
15/03/2015;12;AC;2211134;268489;1942645
15/03/2015;27;AL;112589373;67735151;44854222
15/03/2015;16;AP;28613282;2807533;25805749
15/03/2015;13;AM;62604141;1096694886;-1034090745
15/03/2015;29;BA;561032207;963873424;-402841217
15/03/2015;23;CE;78280946;215278246;-136997300
15/03/2015;53;DF;34946367;89381326;-54434959
15/03/2015;32;ES;892003618;526872798;365130820
15/03/2015;52;GO;599398604;344486202;254912402
15/03/2015;21;MA;221346930;370016706;-148669776
15/03/2015;51;MT;1387482261;89155610;1298326651
15/03/2015;50;MS;409745939;333222212;76523727
15/03/2015;31;MG;2160351370;789879871;1370471499
15/03/2015;15;PA;849977567;113650102;736327465
15/03/2015;25;PB;13489246;55500431;-42011185
15/03/2015;41;PR;1238203400;1131182628;107020772
15/03/2015;26;PE;47721646;526136490;-478414844
15/03/2015;22;PI;8155584;18320742;-10165158
15/03/2015;33;RJ;1102129710;1408640689;-306510979
15/03/2015;24;RN;16963915;13260728;3703187
15/03/2015;43;RS;1252205384;1018901914;233303470
15/03/2015;11;RO;90936739;57457136;33479603
15/03/2015;14;RR;1275212;1101922;173290
15/03/2015;42;SC;677056727;1283904139;-606847412
15/03/2015;35;SP;4410038595;5954308618;-1544270023
15/03/2015;28;SE;7974623;19566285;-11591662
15/03/2015;17;TO;70815844;27693040;43122804
15/04/2015;12;AC;2106762;2550306;-443544
15/04/2015;27;AL;18668604;36683542;-18014938
15/04/2015;16;AP;7444431;5490750;1953681
15/04/2015;13;AM;63000007;866254200;-803254193
15/04/2015;29;BA;619580317;701654579;-82074262
15/04/2015;23;CE;74072153;211603896;-137531743
15/04/2015;53;DF;13714812;94142571;-80427759
15/04/2015;32;ES;761881546;446654438;315227108
15/04/2015;52;GO;397874545;247037690;150836855
15/04/2015;21;MA;279562647;389964319;-110401672
15/04/2015;51;MT;896842441;83911798;812930643
15/04/2015;50;MS;329490932;313017275;16473657
15/04/2015;31;MG;1600332214;782185065;818147149
15/04/2015;15;PA;849118266;134662868;714455398
15/04/2015;25;PB;9752520;54956988;-45204468
15/04/2015;41;PR;1382949448;1047248497;335700951
15/04/2015;26;PE;46283353;526530861;-480247508
15/04/2015;22;PI;20188461;7040162;13148299
15/04/2015;33;RJ;1278101229;1181201194;96900035
15/04/2015;24;RN;18769204;14262132;4507072
15/04/2015;43;RS;1645155187;918137683;727017504
15/04/2015;11;RO;112440514;68748267;43692247
15/04/2015;14;RR;2621398;1656200;965198
15/04/2015;42;SC;786513864;1087157005;-300643141
15/04/2015;35;SP;3225661181;5415997467;-2190336286
15/04/2015;28;SE;5071241;17207312;-12136071
15/04/2015;17;TO;137782440;8605262;129177178
15/05/2015;12;AC;1502494;173897;1328597
15/05/2015;27;AL;46149291;37866777;8282514
15/05/2015;16;AP;18069411;2908877;15160534
15/05/2015;13;AM;74060995;821739889;-747678894
15/05/2015;29;BA;602600696;550475017;52125679
15/05/2015;23;CE;72147896;252532919;-180385023
15/05/2015;53;DF;18965572;101351923;-82386351
15/05/2015;32;ES;918216860;435255069;482961791
15/05/2015;52;GO;534305437;356886447;177418990
15/05/2015;21;MA;284874691;315653151;-30778460
15/05/2015;51;MT;1499690497;112013254;1387677243
15/05/2015;50;MS;516174328;278365459;237808869
15/05/2015;31;MG;1771225153;752374811;1018850342
15/05/2015;15;PA;740481854;71611137;668870717
15/05/2015;25;PB;18165936;36499126;-18333190
15/05/2015;41;PR;1252063796;1079576929;172486867
15/05/2015;26;PE;117363972;501533347;-384169375
15/05/2015;22;PI;55570200;15397499;40172701
15/05/2015;33;RJ;1286731651;1230589763;56141888
15/05/2015;24;RN;13426802;17357662;-3930860
15/05/2015;43;RS;1582817581;792275880;790541701
15/05/2015;11;RO;102914779;45850930;57063849
15/05/2015;14;RR;287414;1027840;-740426
15/05/2015;42;SC;758031265;956083853;-198052588
15/05/2015;35;SP;3810776948;5214214662;-1403437714
15/05/2015;28;SE;4500368;25789788;-21289420
15/05/2015;17;TO;173511467;8164490;165346977
15/06/2015;12;AC;1530561;148604;1381957
15/06/2015;27;AL;14601995;43757117;-29155122
15/06/2015;16;AP;17021322;2817382;14203940
15/06/2015;13;AM;60511051;699091270;-638580219
15/06/2015;29;BA;651539369;720753049;-69213680
15/06/2015;23;CE;80671748;157723921;-77052173
15/06/2015;53;DF;28496923;83496123;-54999200
15/06/2015;32;ES;945671939;436230874;509441065
15/06/2015;52;GO;657003927;304930662;352073265
15/06/2015;21;MA;338112742;323681148;14431594
15/06/2015;51;MT;1487113312;146073613;1341039699
15/06/2015;50;MS;535149500;276525858;258623642
15/06/2015;31;MG;1893083954;853002130;1040081824
15/06/2015;15;PA;961684326;100641638;861042688
15/06/2015;25;PB;9744951;33093290;-23348339
15/06/2015;41;PR;1695621082;1237000982;458620100
15/06/2015;26;PE;71959204;384507611;-312548407
15/06/2015;22;PI;68523991;7616475;60907516
15/06/2015;33;RJ;1575553125;1605241572;-29688447
15/06/2015;24;RN;60303324;17354072;42949252
15/06/2015;43;RS;1725498303;878077910;847420393
15/06/2015;11;RO;123040712;58476041;64564671
15/06/2015;14;RR;955943;867697;88246
15/06/2015;42;SC;728448497;989620777;-261172280
15/06/2015;35;SP;4454680267;5705860127;-1251179860
15/06/2015;28;SE;6063072;22961109;-16898037
15/06/2015;17;TO;127768174;10763797;117004377
15/07/2015;12;AC;1406433;118108;1288325
15/07/2015;27;AL;44667506;38956988;5710518
15/07/2015;16;AP;16784947;3792083;12992864
15/07/2015;13;AM;82912093;740560603;-657648510
15/07/2015;29;BA;798069636;807220565;-9150929
15/07/2015;23;CE;88932536;223833930;-134901394
15/07/2015;53;DF;29438637;107596383;-78157746
15/07/2015;32;ES;758615236;513153844;245461392
15/07/2015;52;GO;567927862;313219270;254708592
15/07/2015;21;MA;362947045;193308886;169638159
15/07/2015;51;MT;1423417626;124538263;1298879363
15/07/2015;50;MS;546735696;305736094;240999602
15/07/2015;31;MG;2038518049;816647001;1221871048
15/07/2015;15;PA;1076492601;72990609;1003501992
15/07/2015;25;PB;9605300;66279909;-56674609
15/07/2015;41;PR;1526734363;1175177557;351556806
15/07/2015;26;PE;101779094;584821271;-483042177
15/07/2015;22;PI;75220739;11045956;64174783
15/07/2015;33;RJ;1369262060;2010763686;-641501626
15/07/2015;24;RN;14331159;84586944;-70255785
15/07/2015;43;RS;1825559950;1110486948;715073002
15/07/2015;11;RO;108293475;70434835;37858640
15/07/2015;14;RR;359609;992895;-633286
15/07/2015;42;SC;680839308;1128446155;-447606847
15/07/2015;35;SP;4303584229;5595205871;-1291621642
15/07/2015;28;SE;6898479;24684820;-17786341
15/07/2015;17;TO;91527629;13620650;77906979
15/08/2015;12;AC;869236;592640;276596
15/08/2015;27;AL;1605132;69927828;-68322696
15/08/2015;16;AP;9802960;3557092;6245868
15/08/2015;13;AM;73493073;694971588;-621478515
15/08/2015;29;BA;699444231;448377224;251067007
15/08/2015;23;CE;80010950;136616138;-56605188
15/08/2015;53;DF;30266603;78588067;-48321464
15/08/2015;32;ES;846438610;417927129;428511481
15/08/2015;52;GO;458973017;305743169;153229848
15/08/2015;21;MA;255012041;68838762;186173279
15/08/2015;51;MT;1004310701;89048518;915262183
15/08/2015;50;MS;335437972;257601979;77835993
15/08/2015;31;MG;1727835717;700162867;1027672850
15/08/2015;15;PA;670859776;44099379;626760397
15/08/2015;25;PB;6431901;29613746;-23181845
15/08/2015;41;PR;1407694029;1021844418;385849611
15/08/2015;26;PE;72984330;320620373;-247636043
15/08/2015;22;PI;54973475;3016315;51957160
15/08/2015;33;RJ;1271017961;1203836640;67181321
15/08/2015;24;RN;21365439;29863387;-8497948
15/08/2015;43;RS;1595089964;732094268;862995696
15/08/2015;11;RO;67812554;56957370;10855184
15/08/2015;14;RR;436959;790063;-353104
15/08/2015;42;SC;630153838;1045277808;-415123970
15/08/2015;35;SP;3566252983;5020136535;-1453883552
15/08/2015;28;SE;12219954;8986851;3233103
15/08/2015;17;TO;62395808;6960134;55435674
15/09/2015;12;AC;1162296;976139;186157
15/09/2015;27;AL;11131206;40079651;-28948445
15/09/2015;16;AP;20579507;8145042;12434465
15/09/2015;13;AM;56645621;765853774;-709208153
15/09/2015;29;BA;892173553;583546038;308627515
15/09/2015;23;CE;95899466;243164276;-147264810
15/09/2015;53;DF;30985200;115780870;-84795670
15/09/2015;32;ES;809301256;384590219;424711037
15/09/2015;52;GO;434051559;273680303;160371256
15/09/2015;21;MA;285787481;178655964;107131517
15/09/2015;51;MT;912224208;169951422;742272786
15/09/2015;50;MS;343082576;257766862;85315714
15/09/2015;31;MG;1912791758;646060050;1266731708
15/09/2015;15;PA;879680988;56872945;822808043
15/09/2015;25;PB;14734817;26314371;-11579554
15/09/2015;41;PR;1293031949;1094277874;198754075
15/09/2015;26;PE;48404955;371740974;-323336019
15/09/2015;22;PI;53041637;8456835;44584802
15/09/2015;33;RJ;987008124;1184760695;-197752571
15/09/2015;24;RN;28878389;7982267;20896122
15/09/2015;43;RS;1702250558;700204411;1002046147
15/09/2015;11;RO;81038253;55162831;25875422
15/09/2015;14;RR;255853;336447;-80594
15/09/2015;42;SC;590950411;974841870;-383891459
15/09/2015;35;SP;3435866877;5032454159;-1596587282
15/09/2015;28;SE;13242028;10212709;3029319
15/09/2015;17;TO;67452555;6691564;60760991
15/10/2015;12;AC;1162921;41039;1121882
15/10/2015;27;AL;22394251;28160919;-5766668
15/10/2015;16;AP;39690760;2113627;37577133
15/10/2015;13;AM;75270855;650083722;-574812867
15/10/2015;29;BA;744040417;621723535;122316882
15/10/2015;23;CE;98567102;146785101;-48217999
15/10/2015;53;DF;23083211;155024415;-131941204
15/10/2015;32;ES;519131035;383566117;135564918
15/10/2015;52;GO;516094313;263275799;252818514
15/10/2015;21;MA;245244510;197065028;48179482
15/10/2015;51;MT;1068502827;85135662;983367165
15/10/2015;50;MS;374988216;246469136;128519080
15/10/2015;31;MG;1954698628;766543156;1188155472
15/10/2015;15;PA;895875523;63241405;832634118
15/10/2015;25;PB;10425740;130193463;-119767723
15/10/2015;41;PR;1161793869;983930177;177863692
15/10/2015;26;PE;102136169;349050023;-246913854
15/10/2015;22;PI;27941098;2944498;24996600
15/10/2015;33;RJ;1154714808;1703684547;-548969739
15/10/2015;24;RN;47804597;8162506;39642091
15/10/2015;43;RS;1528127085;797983294;730143791
15/10/2015;11;RO;60949521;61257680;-308159
15/10/2015;14;RR;4602412;178727;4423685
15/10/2015;42;SC;540047488;846524607;-306477119
15/10/2015;35;SP;4041695225;5531240836;-1489545611
15/10/2015;28;SE;12318779;19335622;-7016843
15/10/2015;17;TO;79907973;9883159;70024814
15/11/2015;12;AC;614319;168636;445683
15/11/2015;27;AL;208355675;37830540;170525135
15/11/2015;16;AP;17586027;5635449;11950578
15/11/2015;13;AM;67559933;458515368;-390955435
15/11/2015;29;BA;558132414;661382763;-103250349
15/11/2015;23;CE;88797565;165346309;-76548744
15/11/2015;53;DF;39776014;45306591;-5530577
15/11/2015;32;ES;373123833;358905377;14218456
15/11/2015;52;GO;449579887;248272415;201307472
15/11/2015;21;MA;172791553;281740261;-108948708
15/11/2015;51;MT;985399106;89883956;895515150
15/11/2015;50;MS;358522093;212489599;146032494
15/11/2015;31;MG;1616695300;759336471;857358829
15/11/2015;15;PA;774867146;56478146;718389000
15/11/2015;25;PB;9851187;16363736;-6512549
15/11/2015;41;PR;994810222;879838780;114971442
15/11/2015;26;PE;80335222;353918595;-273583373
15/11/2015;22;PI;15239817;7319588;7920229
15/11/2015;33;RJ;867926665;1318658808;-450732143
15/11/2015;24;RN;30083038;11563498;18519540
15/11/2015;43;RS;1308075388;836344033;471731355
15/11/2015;11;RO;62476702;37654003;24822699
15/11/2015;14;RR;160625;534297;-373672
15/11/2015;42;SC;578138535;922529316;-344390781
15/11/2015;35;SP;3430374055;4811902122;-1381528067
15/11/2015;28;SE;10102391;18873481;-8771090
15/11/2015;17;TO;37659706;11357775;26301931
15/12/2015;12;AC;714800;299691;415109
15/12/2015;27;AL;78480601;108775650;-30295049
15/12/2015;16;AP;9364771;3706487;5658284
15/12/2015;13;AM;47304404;305235478;-257931074
15/12/2015;29;BA;624219386;530801367;93418019
15/12/2015;23;CE;112612494;124300073;-11687579
15/12/2015;53;DF;12333117;121611642;-109278525
15/12/2015;32;ES;875927242;313249276;562677966
15/12/2015;52;GO;550784364;210339863;340444501
15/12/2015;21;MA;208734995;75313611;133421384
15/12/2015;51;MT;1122256784;88161686;1034095098
15/12/2015;50;MS;406510355;207001128;199509227
15/12/2015;31;MG;1728527038;552978844;1175548194
15/12/2015;15;PA;814980479;66947414;748033065
15/12/2015;25;PB;16876738;26448974;-9572236
15/12/2015;41;PR;1129395072;741062235;388332837
15/12/2015;26;PE;268892321;274542871;-5650550
15/12/2015;22;PI;7279379;2777414;4501965
15/12/2015;33;RJ;1029829897;1449897410;-420067513
15/12/2015;24;RN;29427990;11862077;17565913
15/12/2015;43;RS;1113507794;656899766;456608028
15/12/2015;11;RO;65666421;36083018;29583403
15/12/2015;14;RR;282955;218633;64322
15/12/2015;42;SC;584980789;738701003;-153720214
15/12/2015;35;SP;4361041762;3882503066;478538696
15/12/2015;28;SE;7642567;14597896;-6955329
15/12/2015;17;TO;20457475;9312438;11145037
15/01/2016;12;AC;1464834;195355;1269479
15/01/2016;27;AL;49262524;29906010;19356514
15/01/2016;16;AP;34836821;681343;34155478
15/01/2016;13;AM;36964608;525551711;-488587103
15/01/2016;29;BA;439452266;307671769;131780497
15/01/2016;23;CE;77647431;100336807;-22689376
15/01/2016;53;DF;9371554;126235434;-116863880
15/01/2016;32;ES;504133596;357255712;146877884
15/01/2016;52;GO;475938953;215883540;260055413
15/01/2016;21;MA;147537499;62383725;85153774
15/01/2016;51;MT;789413496;73959299;715454197
15/01/2016;50;MS;318394580;205127414;113267166
15/01/2016;31;MG;1289011773;665091588;623920185
15/01/2016;15;PA;640213795;63331330;576882465
15/01/2016;25;PB;12971758;29656658;-16684900
15/01/2016;41;PR;871191464;741940455;129251009
15/01/2016;26;PE;71895183;218993251;-147098068
15/01/2016;22;PI;6146276;4629159;1517117
15/01/2016;33;RJ;1099104989;1431997151;-332892162
15/01/2016;24;RN;21879821;16419119;5460702
15/01/2016;43;RS;810502807;361765478;448737329
15/01/2016;11;RO;46763042;39420214;7342828
15/01/2016;14;RR;111655;380297;-268642
15/01/2016;42;SC;411075312;754203091;-343127779
15/01/2016;35;SP;2483782123;3974331902;-1490549779
15/01/2016;28;SE;7783293;12237976;-4454683
15/01/2016;17;TO;25178941;3060420;22118521
15/02/2016;12;AC;1639049;103234;1535815
15/02/2016;27;AL;38696248;50821937;-12125689
15/02/2016;16;AP;6169301;922284;5247017
15/02/2016;13;AM;58708465;439600861;-380892396
15/02/2016;29;BA;535075355;542185483;-7110128
15/02/2016;23;CE;80905307;188024311;-107119004
15/02/2016;53;DF;8327636;230325635;-221997999
15/02/2016;32;ES;428459057;266951208;161507849
15/02/2016;52;GO;436002052;218023944;217978108
15/02/2016;21;MA;139541291;142581099;-3039808
15/02/2016;51;MT;1211619587;81818392;1129801195
15/02/2016;50;MS;382427653;198156128;184271525
15/02/2016;31;MG;1468987665;483518764;985468901
15/02/2016;15;PA;656970974;74352319;582618655
15/02/2016;25;PB;9962677;17089237;-7126560
15/02/2016;41;PR;995168588;771813757;223354831
15/02/2016;26;PE;57490786;370113956;-312623170
15/02/2016;22;PI;6079628;1713612;4366016
15/02/2016;33;RJ;765428800;773597609;-8168809
15/02/2016;24;RN;19878829;4725617;15153212
15/02/2016;43;RS;858575298;731057323;127517975
15/02/2016;11;RO;75376612;38634942;36741670
15/02/2016;14;RR;194796;1261345;-1066549
15/02/2016;42;SC;544469934;759310513;-214840579
15/02/2016;35;SP;3933717483;3906335826;27381657
15/02/2016;28;SE;6031844;10408782;-4376938
15/02/2016;17;TO;16500690;6078011;10422679
15/03/2016;12;AC;1750806;119555;1631251
15/03/2016;27;AL;44891916;74834301;-29942385
15/03/2016;16;AP;24137569;732113;23405456
15/03/2016;13;AM;64254218;468830950;-404576732
15/03/2016;29;BA;569226406;434056870;135169536
15/03/2016;23;CE;79247307;211540602;-132293295
15/03/2016;53;DF;15729413;162014115;-146284702
15/03/2016;32;ES;342288033;311844829;30443204
15/03/2016;52;GO;681178245;248856846;432321399
15/03/2016;21;MA;201463034;411147314;-209684280
15/03/2016;51;MT;1801526831;135565788;1665961043
15/03/2016;50;MS;560308343;190572722;369735621
15/03/2016;31;MG;1703522104;569921148;1133600956
15/03/2016;15;PA;750582928;185797340;564785588
15/03/2016;25;PB;8077638;22809832;-14732194
15/03/2016;41;PR;1473360063;935310797;538049266
15/03/2016;26;PE;72249505;329464940;-257215435
15/03/2016;22;PI;12164939;7094194;5070745
15/03/2016;33;RJ;985977459;1027225057;-41247598
15/03/2016;24;RN;19169945;12461372;6708573
15/03/2016;43;RS;1139627933;674502928;465125005
15/03/2016;11;RO;95671331;41942485;53728846
15/03/2016;14;RR;1464671;219060;1245611
15/03/2016;42;SC;633459799;802307168;-168847369
15/03/2016;35;SP;4064825757;4279446634;-214620877
15/03/2016;28;SE;5443418;10548229;-5104811
15/03/2016;17;TO;55371633;12262907;43108726
15/04/2016;12;AC;1439903;79057;1360846
15/04/2016;27;AL;26022755;41923827;-15901072
15/04/2016;16;AP;5594379;1554597;4039782
15/04/2016;13;AM;49797600;401655530;-351857930
15/04/2016;29;BA;640236215;712810928;-72574713
15/04/2016;23;CE;75812886;96928184;-21115298
15/04/2016;53;DF;14363762;115079502;-100715740
15/04/2016;32;ES;444374310;291949531;152424779
15/04/2016;52;GO;601756225;201723361;400032864
15/04/2016;21;MA;220655795;134503507;86152288
15/04/2016;51;MT;1515058565;124014394;1391044171
15/04/2016;50;MS;403149756;202284240;200865516
15/04/2016;31;MG;1724985981;528144768;1196841213
15/04/2016;15;PA;756497740;121602614;634895126
15/04/2016;25;PB;7145337;28138982;-20993645
15/04/2016;41;PR;1476016300;857000959;619015341
15/04/2016;26;PE;84821787;453724615;-368902828
15/04/2016;22;PI;19031240;3156197;15875043
15/04/2016;33;RJ;845086496;790501826;54584670
15/04/2016;24;RN;20755220;15443770;5311450
15/04/2016;43;RS;1311719927;597604836;714115091
15/04/2016;11;RO;136377078;29840865;106536213
15/04/2016;14;RR;345258;191921;153337
15/04/2016;42;SC;659391582;740152265;-80760683
15/04/2016;35;SP;3482947845;4004030083;-521082238
15/04/2016;28;SE;4596024;10821682;-6225658
15/04/2016;17;TO;121164044;5707816;115456228
15/05/2016;12;AC;1051169;276707;774462
15/05/2016;27;AL;45467893;32101852;13366041
15/05/2016;16;AP;28369528;1455249;26914279
15/05/2016;13;AM;47910890;535580220;-487669330
15/05/2016;29;BA;704602480;649232332;55370148
15/05/2016;23;CE;80777444;123919751;-43142307
15/05/2016;53;DF;13669622;88352465;-74682843
15/05/2016;32;ES;491966429;278920866;213045563
15/05/2016;52;GO;579972389;214333500;365638889
15/05/2016;21;MA;206297751;190526387;15771364
15/05/2016;51;MT;1586566762;96040068;1490526694
15/05/2016;50;MS;356423901;166033312;190390589
15/05/2016;31;MG;2039213159;570898518;1468314641
15/05/2016;15;PA;938780719;85552272;853228447
15/05/2016;25;PB;7896533;17479001;-9582468
15/05/2016;41;PR;1496087013;833061509;663025504
15/05/2016;26;PE;130497495;360286071;-229788576
15/05/2016;22;PI;33757869;6175318;27582551
15/05/2016;33;RJ;822755157;1224513608;-401758451
15/05/2016;24;RN;15482347;11359225;4123122
15/05/2016;43;RS;1775916601;622744262;1153172339
15/05/2016;11;RO;130850677;42673681;88176996
15/05/2016;14;RR;344947;342616;2331
15/05/2016;42;SC;693174951;832720626;-139545675
15/05/2016;35;SP;3777687796;4129550703;-351862907
15/05/2016;28;SE;5212669;18394012;-13181343
15/05/2016;17;TO;122869645;7622882;115246763
15/06/2016;12;AC;823109;50485;772624
15/06/2016;27;AL;27595155;39094466;-11499311
15/06/2016;16;AP;26381569;1101690;25279879
15/06/2016;13;AM;45882842;473839831;-427956989
15/06/2016;29;BA;499813435;443975138;55838297
15/06/2016;23;CE;78286893;1454058411;-1375771518
15/06/2016;53;DF;15616157;56492270;-40876113
15/06/2016;32;ES;488799136;306887520;181911616
15/06/2016;52;GO;603013073;204601330;398411743
15/06/2016;21;MA;203570736;208326610;-4755874
15/06/2016;51;MT;1312235284;141787821;1170447463
15/06/2016;50;MS;331876935;160313363;171563572
15/06/2016;31;MG;1818250431;552145196;1266105235
15/06/2016;15;PA;866184169;104062513;762121656
15/06/2016;25;PB;11292881;19685348;-8392467
15/06/2016;41;PR;1470558163;978451578;492106585
15/06/2016;26;PE;144938454;488811438;-343872984
15/06/2016;22;PI;29085636;7351824;21733812
15/06/2016;33;RJ;1220876744;1024483748;196392996
15/06/2016;24;RN;16676803;29834414;-13157611
15/06/2016;43;RS;1801873093;666503518;1135369575
15/06/2016;11;RO;89919802;46971570;42948232
15/06/2016;14;RR;171558;1297333;-1125775
15/06/2016;42;SC;667504560;805914220;-138409660
15/06/2016;35;SP;4270266515;4541063611;-270797096
15/06/2016;28;SE;8619154;8025489;593665
15/06/2016;17;TO;101211258;6508563;94702695
15/07/2016;12;AC;532547;26737;505810
15/07/2016;27;AL;10529114;54059282;-43530168
15/07/2016;16;AP;6579629;1196367;5383262
15/07/2016;13;AM;39118695;509893951;-470775256
15/07/2016;29;BA;535795355;803250743;-267455388
15/07/2016;23;CE;86265995;535978814;-449712819
15/07/2016;53;DF;16423147;46181632;-29758485
15/07/2016;32;ES;410608096;259743939;150864157
15/07/2016;52;GO;458495673;218856617;239639056
15/07/2016;21;MA;182102079;194392319;-12290240
15/07/2016;51;MT;1071662243;116902821;954759422
15/07/2016;50;MS;356779143;171720770;185058373
15/07/2016;31;MG;1771974290;464270623;1307703667
15/07/2016;15;PA;881558745;69390873;812167872
15/07/2016;25;PB;9300384;28067687;-18767303
15/07/2016;41;PR;1378878383;1032332296;346546087
15/07/2016;26;PE;67231445;321730598;-254499153
15/07/2016;22;PI;9757389;1958045;7799344
15/07/2016;33;RJ;1067510003;1085182772;-17672769
15/07/2016;24;RN;16817845;16445579;372266
15/07/2016;43;RS;1732944572;611404057;1121540515
15/07/2016;11;RO;78636626;46593207;32043419
15/07/2016;14;RR;756994;440152;316842
15/07/2016;42;SC;658036340;863985146;-205948806
15/07/2016;35;SP;3828884085;4281149690;-452265605
15/07/2016;28;SE;10389233;10195128;194105
15/07/2016;17;TO;72683084;8508309;64174775
15/08/2016;12;AC;736558;114206;622352
15/08/2016;27;AL;1049626;44819346;-43769720
15/08/2016;16;AP;13485024;2601265;10883759
15/08/2016;13;AM;46180009;600167345;-553987336
15/08/2016;29;BA;647209234;649485989;-2276755
15/08/2016;23;CE;126259032;125245896;1013136
15/08/2016;53;DF;22437000;122733672;-100296672
15/08/2016;32;ES;504472285;338990291;165481994
15/08/2016;52;GO;530184075;265836093;264347982
15/08/2016;21;MA;213928840;218734676;-4805836
15/08/2016;51;MT;954911053;124187384;830723669
15/08/2016;50;MS;300257650;211638393;88619257
15/08/2016;31;MG;2118887181;573245122;1545642059
15/08/2016;15;PA;965806873;136219636;829587237
15/08/2016;25;PB;9838114;21268583;-11430469
15/08/2016;41;PR;1318466332;1069294391;249171941
15/08/2016;26;PE;98229000;413482382;-315253382
15/08/2016;22;PI;20740895;11519965;9220930
15/08/2016;33;RJ;1304884018;1082161700;222722318
15/08/2016;24;RN;19682315;17233915;2448400
15/08/2016;43;RS;1748310089;832762612;915547477
15/08/2016;11;RO;50848546;49600601;1247945
15/08/2016;14;RR;810005;708650;101355
15/08/2016;42;SC;728927677;990824537;-261896860
15/08/2016;35;SP;4381987095;4916335885;-534348790
15/08/2016;28;SE;15275068;12686361;2588707
15/08/2016;17;TO;52742741;19009460;33733281
15/09/2016;12;AC;355635;435454;-79819
15/09/2016;27;AL;1673697;43941459;-42267762
15/09/2016;16;AP;28101079;2839599;25261480
15/09/2016;13;AM;50211833;606607227;-556395394
15/09/2016;29;BA;578857646;476386281;102471365
15/09/2016;23;CE;142718518;184917419;-42198901
15/09/2016;53;DF;19271840;113580541;-94308701
15/09/2016;32;ES;579853250;337918843;241934407
15/09/2016;52;GO;513887479;235040437;278847042
15/09/2016;21;MA;167225735;118201343;49024392
15/09/2016;51;MT;799617111;81113721;718503390
15/09/2016;50;MS;310886604;190149879;120736725
15/09/2016;31;MG;2027267827;589478841;1437788986
15/09/2016;15;PA;978036095;48979743;929056352
15/09/2016;25;PB;10959234;39021727;-28062493
15/09/2016;41;PR;1249898625;1050545422;199353203
15/09/2016;26;PE;205525490;424234760;-218709270
15/09/2016;22;PI;18049506;10298025;7751481
15/09/2016;33;RJ;1330959600;1028320361;302639239
15/09/2016;24;RN;29682083;16632408;13049675
15/09/2016;43;RS;1300031427;709414461;590616966
15/09/2016;11;RO;49579469;51072882;-1493413
15/09/2016;14;RR;625414;340945;284469
15/09/2016;42;SC;645679748;968462652;-322782904
15/09/2016;35;SP;4102058950;4637993467;-535934517
15/09/2016;28;SE;12070710;20324557;-8253847
15/09/2016;17;TO;15970660;9720702;6249958
15/10/2016;12;AC;369809;117497;252312
15/10/2016;27;AL;23655323;52632307;-28976984
15/10/2016;16;AP;55067638;1251060;53816578
15/10/2016;13;AM;45249154;547796024;-502546870
15/10/2016;29;BA;584994735;457742604;127252131
15/10/2016;23;CE;145379341;147047463;-1668122
15/10/2016;53;DF;10459914;154995457;-144535543
15/10/2016;32;ES;405991023;208814209;197176814
15/10/2016;52;GO;323016041;185827121;137188920
15/10/2016;21;MA;132533861;102782991;29750870
15/10/2016;51;MT;525333246;51193848;474139398
15/10/2016;50;MS;242290457;205289238;37001219
15/10/2016;31;MG;1862796227;460546319;1402249908
15/10/2016;15;PA;847487655;94438139;753049516
15/10/2016;25;PB;8392879;25772449;-17379570
15/10/2016;41;PR;1023806840;988112884;35693956
15/10/2016;26;PE;171569006;376798875;-205229869
15/10/2016;22;PI;5653062;18031325;-12378263
15/10/2016;33;RJ;1233472339;1011467377;222004962
15/10/2016;24;RN;28108959;14648683;13460276
15/10/2016;43;RS;1251890604;722063967;529826637
15/10/2016;11;RO;42846543;47446847;-4600304
15/10/2016;14;RR;7591979;512705;7079274
15/10/2016;42;SC;608378937;965615865;-357236928
15/10/2016;35;SP;3551570949;4526707122;-975136173
15/10/2016;28;SE;13289880;7327423;5962457
15/10/2016;17;TO;18294278;6948433;11345845
15/11/2016;12;AC;1105692;88035;1017657
15/11/2016;27;AL;75913329;50530181;25383148
15/11/2016;16;AP;10343124;17626508;-7283384
15/11/2016;13;AM;45301760;599136346;-553834586
15/11/2016;29;BA;502100121;340469073;161631048
15/11/2016;23;CE;161821271;160322718;1498553
15/11/2016;53;DF;11721005;57999634;-46278629
15/11/2016;32;ES;531070926;360730213;170340713
15/11/2016;52;GO;305922805;245458023;60464782
15/11/2016;21;MA;192293331;142686939;49606392
15/11/2016;51;MT;509651856;77867370;431784486
15/11/2016;50;MS;260240490;202786129;57454361
15/11/2016;31;MG;1852256756;523799881;1328456875
15/11/2016;15;PA;983469680;60169028;923300652
15/11/2016;25;PB;11540538;27460059;-15919521
15/11/2016;41;PR;1026790937;946073175;80717762
15/11/2016;26;PE;151423226;343296014;-191872788
15/11/2016;22;PI;4856583;9084165;-4227582
15/11/2016;33;RJ;1395155109;1082765663;312389446
15/11/2016;24;RN;28029084;13809311;14219773
15/11/2016;43;RS;1219595242;868891737;350703505
15/11/2016;11;RO;36409121;56387917;-19978796
15/11/2016;14;RR;2093688;1076988;1016700
15/11/2016;42;SC;621021415;954706525;-333685110
15/11/2016;35;SP;3783895114;4298974389;-515079275
15/11/2016;28;SE;14501562;8592586;5908976
15/11/2016;17;TO;16927112;17072493;-145381
15/12/2016;12;AC;1360817;139643;1221174
15/12/2016;27;AL;76102358;65083089;11019269
15/12/2016;16;AP;25019181;17577607;7441574
15/12/2016;13;AM;45401503;557721037;-512319534
15/12/2016;29;BA;492059032;350193409;141865623
15/12/2016;23;CE;158980610;162469216;-3488606
15/12/2016;53;DF;7158544;216935438;-209776894
15/12/2016;32;ES;679745721;384746597;294999124
15/12/2016;52;GO;419704717;188713056;230991661
15/12/2016;21;MA;202679861;175775506;26904355
15/12/2016;51;MT;510636258;80797519;429838739
15/12/2016;50;MS;248022767;199316335;48706432
15/12/2016;31;MG;2240195009;578155718;1662039291
15/12/2016;15;PA;1245478243;67195648;1178282595
15/12/2016;25;PB;14087887;36494165;-22406278
15/12/2016;41;PR;1234677571;962919443;271758128
15/12/2016;26;PE;160960969;351060039;-190099070
15/12/2016;22;PI;9679221;11680981;-2001760
15/12/2016;33;RJ;887686165;975364148;-87677983
15/12/2016;24;RN;48414032;15550257;32863775
15/12/2016;43;RS;1240180117;890436666;349743451
15/12/2016;11;RO;43628202;53546839;-9918637
15/12/2016;14;RR;440501;331015;109486
15/12/2016;42;SC;720349120;862269927;-141920807
15/12/2016;35;SP;4362970936;4295309324;67661612
15/12/2016;28;SE;10162315;16307211;-6144896
15/12/2016;17;TO;13931146;14400622;-469476
15/01/2017;12;AC;1652855;215243;1437612
15/01/2017;27;AL;57535095;42176420;15358675
15/01/2017;16;AP;30872062;5331808;25540254
15/01/2017;13;AM;41286438;694032972;-652746534
15/01/2017;29;BA;560936077;882613345;-321677268
15/01/2017;23;CE;156470425;203194907;-46724482
15/01/2017;53;DF;9086110;43966371;-34880261
15/01/2017;32;ES;586321494;346121993;240199501
15/01/2017;52;GO;385466761;265338221;120128540
15/01/2017;21;MA;155984808;160053096;-4068288
15/01/2017;51;MT;705236327;100974874;604261453
15/01/2017;50;MS;293389262;184570688;108818574
15/01/2017;31;MG;2120272198;572887074;1547385124
15/01/2017;15;PA;1139343151;91076583;1048266568
15/01/2017;25;PB;14043781;33104936;-19061155
15/01/2017;41;PR;965187369;963286375;1900994
15/01/2017;26;PE;161103703;441755906;-280652203
15/01/2017;22;PI;6408479;48528919;-42120440
15/01/2017;33;RJ;1885160750;1085794709;799366041
15/01/2017;24;RN;34304871;13582197;20722674
15/01/2017;43;RS;1074542626;596962484;477580142
15/01/2017;11;RO;49198363;50433091;-1234728
15/01/2017;14;RR;239636;647799;-408163
15/01/2017;42;SC;563802617;973494922;-409692305
15/01/2017;35;SP;3408502203;4379211890;-970709687
15/01/2017;28;SE;6653077;11218315;-4565238
15/01/2017;17;TO;12771378;11907704;863674
15/02/2017;12;AC;1516783;159326;1357457
15/02/2017;27;AL;77035870;39400835;37635035
15/02/2017;16;AP;32424326;8760809;23663517
15/02/2017;13;AM;47311005;528587014;-481276009
15/02/2017;29;BA;462519919;418115984;44403935
15/02/2017;23;CE;175343774;126895147;48448627
15/02/2017;53;DF;35109037;173735048;-138626011
15/02/2017;32;ES;568843270;304623786;264219484
15/02/2017;52;GO;447587817;235554317;212033500
15/02/2017;21;MA;178452260;372229261;-193777001
15/02/2017;51;MT;991757182;123386077;868371105
15/02/2017;50;MS;286751416;143851003;142900413
15/02/2017;31;MG;1934100218;507486129;1426614089
15/02/2017;15;PA;946340376;103102175;843238201
15/02/2017;25;PB;7576203;23383504;-15807301
15/02/2017;41;PR;1181933269;856370001;325563268
15/02/2017;26;PE;190490670;501126126;-310635456
15/02/2017;22;PI;5225200;43189072;-37963872
15/02/2017;33;RJ;2155176236;963162657;1192013579
15/02/2017;24;RN;26349035;7047512;19301523
15/02/2017;43;RS;933901120;732930626;200970494
15/02/2017;11;RO;73835152;49329675;24505477
15/02/2017;14;RR;1498158;490871;1007287
15/02/2017;42;SC;612525345;813982845;-201457500
15/02/2017;35;SP;3470210083;3799075810;-328865727
15/02/2017;28;SE;5984479;9399919;-3415440
15/02/2017;17;TO;15294626;29426754;-14132128
15/03/2017;12;AC;1608660;123342;1485318
15/03/2017;27;AL;235961535;54509127;181452408
15/03/2017;16;AP;7122386;3231916;3890470
15/03/2017;13;AM;43477015;710062516;-666585501
15/03/2017;29;BA;657782564;672970777;-15188213
15/03/2017;23;CE;192526497;251922681;-59396184
15/03/2017;53;DF;30592170;103886367;-73294197
15/03/2017;32;ES;651345460;390604651;260740809
15/03/2017;52;GO;751844380;300404203;451440177
15/03/2017;21;MA;243161328;268839661;-25678333
15/03/2017;51;MT;1581134952;137111832;1444023120
15/03/2017;50;MS;542883644;184278519;358605125
15/03/2017;31;MG;2644280562;788905503;1855375059
15/03/2017;15;PA;1406364411;73754577;1332609834
15/03/2017;25;PB;12856606;33019945;-20163339
15/03/2017;41;PR;1820054860;1073963250;746091610
15/03/2017;26;PE;157201785;528465187;-371263402
15/03/2017;22;PI;16518924;29618449;-13099525
15/03/2017;33;RJ;1784716664;1010061871;774654793
15/03/2017;24;RN;24374453;23794790;579663
15/03/2017;43;RS;1308705575;780711513;527994062
15/03/2017;11;RO;125278371;54269662;71008709
15/03/2017;14;RR;1702085;675906;1026179
15/03/2017;42;SC;768943360;1033054743;-264111383
15/03/2017;35;SP;4228134511;4882745635;-654611124
15/03/2017;28;SE;6248634;17447809;-11199175
15/03/2017;17;TO;90485428;16459964;74025464
15/04/2017;12;AC;1742901;214305;1528596
15/04/2017;27;AL;55274396;40778548;14495848
15/04/2017;16;AP;23946368;16779698;7166670
15/04/2017;13;AM;45745776;676816457;-631070681
15/04/2017;29;BA;607535080;427593362;179941718
15/04/2017;23;CE;94434968;167852744;-73417776
15/04/2017;53;DF;33812425;32624619;1187806
15/04/2017;32;ES;513270643;325369040;187901603
15/04/2017;52;GO;608475409;199508207;408967202
15/04/2017;21;MA;253316541;183240152;70076389
15/04/2017;51;MT;1612543919;125567320;1486976599
15/04/2017;50;MS;461075015;171991116;289083899
15/04/2017;31;MG;1936551368;534838276;1401713092
15/04/2017;15;PA;1173231763;66005365;1107226398
15/04/2017;25;PB;16091495;29627951;-13536456
15/04/2017;41;PR;1536687607;956973835;579713772
15/04/2017;26;PE;142348956;329703632;-187354676
15/04/2017;22;PI;40701590;35124373;5577217
15/04/2017;33;RJ;1119811626;1066699876;53111750
15/04/2017;24;RN;18941793;9808271;9133522
15/04/2017;43;RS;1505802620;768363618;737439002
15/04/2017;11;RO;118571588;53886661;64684927
15/04/2017;14;RR;1036774;335943;700831
15/04/2017;42;SC;687994579;923690459;-235695880
15/04/2017;35;SP;4243894866;4157992848;85902018
15/04/2017;28;SE;6345128;6709268;-364140
15/04/2017;17;TO;163060618;16792337;146268281
15/05/2017;12;AC;1515303;155560;1359743
15/05/2017;27;AL;50980009;55047459;-4067450
15/05/2017;16;AP;12963403;2597395;10366008
15/05/2017;13;AM;52536825;646822085;-594285260
15/05/2017;29;BA;733363931;473059321;260304610
15/05/2017;23;CE;205195908;181554938;23640970
15/05/2017;53;DF;18456569;194989748;-176533179
15/05/2017;32;ES;679492020;382811564;296680456
15/05/2017;52;GO;589972633;328438514;261534119
15/05/2017;21;MA;296949584;217985148;78964436
15/05/2017;51;MT;1630642675;116921060;1513721615
15/05/2017;50;MS;388160952;235296089;152864863
15/05/2017;31;MG;2451507303;602838298;1848669005
15/05/2017;15;PA;1197111063;64281379;1132829684
15/05/2017;25;PB;13717602;44008196;-30290594
15/05/2017;41;PR;1766086281;1074778859;691307422
15/05/2017;26;PE;173515293;360883540;-187368247
15/05/2017;22;PI;61343850;27754790;33589060
15/05/2017;33;RJ;1404050542;1258261601;145788941
15/05/2017;24;RN;13709660;26432190;-12722530
15/05/2017;43;RS;1785607534;705042328;1080565206
15/05/2017;11;RO;109904127;57893085;52011042
15/05/2017;14;RR;1888316;598633;1289683
15/05/2017;42;SC;802130677;942965224;-140834547
15/05/2017;35;SP;4514369558;4803336727;-288967169
15/05/2017;28;SE;21664861;11705026;9959835
15/05/2017;17;TO;177541312;8758504;168782808
15/06/2017;12;AC;2127714;91399;2036315
15/06/2017;27;AL;28051947;48860092;-20808145
15/06/2017;16;AP;14041743;20193613;-6151870
15/06/2017;13;AM;53560927;695603049;-642042122
15/06/2017;29;BA;626444688;571547533;54897155
15/06/2017;23;CE;140640876;176035490;-35394614
15/06/2017;53;DF;27092852;50429633;-23336781
15/06/2017;32;ES;617809119;300286512;317522607
15/06/2017;52;GO;597540124;287705973;309834151
15/06/2017;21;MA;289617850;246233113;43384737
15/06/2017;51;MT;1524013302;194210442;1329802860
15/06/2017;50;MS;422169468;226376432;195793036
15/06/2017;31;MG;2067701882;610231757;1457470125
15/06/2017;15;PA;1062213873;75608527;986605346
15/06/2017;25;PB;9838219;29868856;-20030637
15/06/2017;41;PR;1738072618;1078325629;659746989
15/06/2017;26;PE;161608830;578697957;-417089127
15/06/2017;22;PI;78610939;10232622;68378317
15/06/2017;33;RJ;2190925244;1112357276;1078567968
15/06/2017;24;RN;13276394;16209752;-2933358
15/06/2017;43;RS;1687155439;806157010;880998429
15/06/2017;11;RO;107645966;60219620;47426346
15/06/2017;14;RR;1882951;1195396;687555
15/06/2017;42;SC;738329583;1076499800;-338170217
15/06/2017;35;SP;4680752645;4967507145;-286754500
15/06/2017;28;SE;4492878;6459821;-1966943
15/06/2017;17;TO;127242704;18653182;108589522
15/07/2017;12;AC;1364647;44555;1320092
15/07/2017;27;AL;35845762;48107958;-12262196
15/07/2017;16;AP;21953185;3900136;18053049
15/07/2017;13;AM;62559967;768783983;-706224016
15/07/2017;29;BA;681667924;569528104;112139820
15/07/2017;23;CE;162930430;209547831;-46617401
15/07/2017;53;DF;18919007;26206768;-7287761
15/07/2017;32;ES;617586201;439266413;178319788
15/07/2017;52;GO;606293424;251160720;355132704
15/07/2017;21;MA;301451142;134546343;166904799
15/07/2017;51;MT;1199626267;133385650;1066240617
15/07/2017;50;MS;386240022;196265259;189974763
15/07/2017;31;MG;1737977621;544219998;1193757623
15/07/2017;15;PA;1118678075;79585504;1039092571
15/07/2017;25;PB;7983780;22353038;-14369258
15/07/2017;41;PR;1657409945;1078901410;578508535
15/07/2017;26;PE;147101305;548341040;-401239735
15/07/2017;22;PI;36633281;54472217;-17838936
15/07/2017;33;RJ;1542662263;993332572;549329691
15/07/2017;24;RN;12955858;16627334;-3671476
15/07/2017;43;RS;1590903465;848068628;742834837
15/07/2017;11;RO;107515023;62153889;45361134
15/07/2017;14;RR;3681373;698683;2982690
15/07/2017;42;SC;740353455;1109064167;-368710712
15/07/2017;35;SP;4348659454;4951906912;-603247458
15/07/2017;28;SE;5531257;17247585;-11716328
15/07/2017;17;TO;79303965;12839345;66464620
15/08/2017;12;AC;2146458;80896;2065562
15/08/2017;27;AL;16896879;57742462;-40845583
15/08/2017;16;AP;5731016;13757048;-8026032
15/08/2017;13;AM;66644852;861877725;-795232873
15/08/2017;29;BA;890648687;641260666;249388021
15/08/2017;23;CE;156235194;212672246;-56437052
15/08/2017;53;DF;19070039;43317656;-24247617
15/08/2017;32;ES;640694999;415761941;224933058
15/08/2017;52;GO;690787167;348957840;341829327
15/08/2017;21;MA;313795402;195817635;117977767
15/08/2017;51;MT;1280820080;125638595;1155181485
15/08/2017;50;MS;495218461;212272472;282945989
15/08/2017;31;MG;2027560291;600418345;1427141946
15/08/2017;15;PA;1171293851;87745523;1083548328
15/08/2017;25;PB;8483344;40280806;-31797462
15/08/2017;41;PR;1683404386;1204495494;478908892
15/08/2017;26;PE;160110223;558680773;-398570550
15/08/2017;22;PI;38080854;15991433;22089421
15/08/2017;33;RJ;1701425822;1356478725;344947097
15/08/2017;24;RN;23350131;16010889;7339242
15/08/2017;43;RS;1737495509;878253411;859242098
15/08/2017;11;RO;85409377;81771718;3637659
15/08/2017;14;RR;2066963;905086;1161877
15/08/2017;42;SC;795636830;1154963890;-359327060
15/08/2017;35;SP;4538873894;5499689083;-960815189
15/08/2017;28;SE;8067565;11706220;-3638655
15/08/2017;17;TO;98483606;14915949;83567657
15/09/2017;12;AC;1562398;361850;1200548
15/09/2017;27;AL;3696126;51153142;-47457016
15/09/2017;16;AP;48106432;5401800;42704632
15/09/2017;13;AM;64887437;817022618;-752135181
15/09/2017;29;BA;765882489;529801841;236080648
15/09/2017;23;CE;182360394;215490709;-33130315
15/09/2017;53;DF;16222507;147110166;-130887659
15/09/2017;32;ES;650035497;426742618;223292879
15/09/2017;52;GO;647032423;242722315;404310108
15/09/2017;21;MA;234847296;189564903;45282393
15/09/2017;51;MT;1147705571;108648560;1039057011
15/09/2017;50;MS;446181918;278330007;167851911
15/09/2017;31;MG;2173940319;704953380;1468986939
15/09/2017;15;PA;1260229232;52417168;1207812064
15/09/2017;25;PB;10140091;25201534;-15061443
15/09/2017;41;PR;1541657656;1253808673;287848983
15/09/2017;26;PE;130021061;471415094;-341394033
15/09/2017;22;PI;46268091;13059336;33208755
15/09/2017;33;RJ;1481769403;1137674985;344094418
15/09/2017;24;RN;37166641;11148930;26017711
15/09/2017;43;RS;1609999571;829135237;780864334
15/09/2017;11;RO;67706938;65752126;1954812
15/09/2017;14;RR;1788184;520387;1267797
15/09/2017;42;SC;718305433;1182631769;-464326336
15/09/2017;35;SP;4413447992;5319920231;-906472239
15/09/2017;28;SE;8750158;13339820;-4589662
15/09/2017;17;TO;72440222;13369173;59071049
15/10/2017;12;AC;1633093;314554;1318539
15/10/2017;27;AL;19279420;56123290;-36843870
15/10/2017;16;AP;40030515;6131680;33898835
15/10/2017;13;AM;69990693;814152914;-744162221
15/10/2017;29;BA;726717282;819324319;-92607037
15/10/2017;23;CE;187401764;197753284;-10351520
15/10/2017;53;DF;15502370;63257358;-47754988
15/10/2017;32;ES;708834972;414755669;294079303
15/10/2017;52;GO;580597664;210047550;370550114
15/10/2017;21;MA;219850106;239604649;-19754543
15/10/2017;51;MT;1036486729;60333916;976152813
15/10/2017;50;MS;385971856;274746532;111225324
15/10/2017;31;MG;2279384613;666335857;1613048756
15/10/2017;15;PA;1566014075;76741534;1489272541
15/10/2017;25;PB;15340762;35280789;-19940027
15/10/2017;41;PR;1406991938;1117474304;289517634
15/10/2017;26;PE;229698445;504977025;-275278580
15/10/2017;22;PI;10640675;29714878;-19074203
15/10/2017;33;RJ;1550810422;1156777541;394032881
15/10/2017;24;RN;34778863;11881864;22896999
15/10/2017;43;RS;1587539944;888737216;698802728
15/10/2017;11;RO;70206913;71434875;-1227962
15/10/2017;14;RR;1938446;615448;1322998
15/10/2017;42;SC;725931146;1195031286;-469100140
15/10/2017;35;SP;4424440579;5513474627;-1089034048
15/10/2017;28;SE;5651873;10175095;-4523222
15/10/2017;17;TO;48662867;27011533;21651334
15/11/2017;12;AC;2065599;129647;1935952
15/11/2017;27;AL;38543257;47836243;-9292986
15/11/2017;16;AP;27510944;3383798;24127146
15/11/2017;13;AM;67562858;824087734;-756524876
15/11/2017;29;BA;666905446;545779934;121125512
15/11/2017;23;CE;217129619;166298645;50830974
15/11/2017;53;DF;13020220;81951577;-68931357
15/11/2017;32;ES;682496650;420168089;262328561
15/11/2017;52;GO;536393752;272044832;264348920
15/11/2017;21;MA;315908668;136176491;179732177
15/11/2017;51;MT;976427720;103891687;872536033
15/11/2017;50;MS;331630354;213724452;117905902
15/11/2017;31;MG;2011423272;615991246;1395432026
15/11/2017;15;PA;1129973763;114939785;1015033978
15/11/2017;25;PB;11063283;36432303;-25369020
15/11/2017;41;PR;1355992119;1079790829;276201290
15/11/2017;26;PE;161555140;435480065;-273924925
15/11/2017;22;PI;20304408;8415742;11888666
15/11/2017;33;RJ;1242897560;1295935515;-53037955
15/11/2017;24;RN;30679971;13497245;17182726
15/11/2017;43;RS;1426124200;837855546;588268654
15/11/2017;11;RO;84498395;71057828;13440567
15/11/2017;14;RR;22473007;719809;21753198
15/11/2017;42;SC;627808437;1158257350;-530448913
15/11/2017;35;SP;3926852629;5294952426;-1368099797
15/11/2017;28;SE;4940706;8073427;-3132721
15/11/2017;17;TO;42614832;25583144;17031688
15/12/2017;12;AC;2720015;122610;2597405
15/12/2017;27;AL;45914593;60787591;-14872998
15/12/2017;16;AP;17325576;4322152;13003424
15/12/2017;13;AM;57433070;673042788;-615609718
15/12/2017;29;BA;649911720;653336955;-3425235
15/12/2017;23;CE;231467483;136428577;95038906
15/12/2017;53;DF;14413924;103825946;-89412022
15/12/2017;32;ES;721004450;428417804;292586646
15/12/2017;52;GO;460862659;311826272;149036387
15/12/2017;21;MA;228774874;215488194;13286680
15/12/2017;51;MT;1040656554;75213120;965443434
15/12/2017;50;MS;345405967;204996277;140409690
15/12/2017;31;MG;1960915394;672620591;1288294803
15/12/2017;15;PA;1313465758;90247492;1223218266
15/12/2017;25;PB;13587275;53659644;-40072369
15/12/2017;41;PR;1279688908;942206941;337481967
15/12/2017;26;PE;146639793;445047155;-298407362
15/12/2017;22;PI;36244271;32019123;4225148
15/12/2017;33;RJ;1603685599;1088186055;515499544
15/12/2017;24;RN;34442756;10956756;23486000
15/12/2017;43;RS;1534481762;1238323841;296157921
15/12/2017;11;RO;82926415;82463870;462545
15/12/2017;14;RR;1214198;1082422;131776
15/12/2017;42;SC;724841345;960227527;-235386182
15/12/2017;35;SP;4324000052;4663377391;-339377339
15/12/2017;28;SE;6556958;14507984;-7951026
15/12/2017;17;TO;23360266;20194679;3165587
15/01/2018;12;AC;3988282;74741;3913541
15/01/2018;27;AL;41437449;53332766;-11895317
15/01/2018;16;AP;50574530;1456876;49117654
15/01/2018;13;AM;70525510;1006711304;-936185794
15/01/2018;29;BA;557464034;603975592;-46511558
15/01/2018;23;CE;180543983;195148600;-14604617
15/01/2018;53;DF;12429356;49695713;-37266357
15/01/2018;32;ES;624266111;422696641;201569470
15/01/2018;52;GO;447872304;285361914;162510390
15/01/2018;21;MA;247988547;261883451;-13894904
15/01/2018;51;MT;889961762;70866436;819095326
15/01/2018;50;MS;327827858;210370797;117457061
15/01/2018;31;MG;1968215607;780440222;1187775385
15/01/2018;15;PA;1208208390;146366564;1061841826
15/01/2018;25;PB;14331372;34137937;-19806565
15/01/2018;41;PR;1043887857;1060230398;-16342541
15/01/2018;26;PE;135084954;924830782;-789745828
15/01/2018;22;PI;7720185;12850828;-5130643
15/01/2018;33;RJ;2398572619;1292521199;1106051420
15/01/2018;24;RN;28562058;14479975;14082083
15/01/2018;43;RS;1287964015;658294764;629669251
15/01/2018;11;RO;57704860;76186202;-18481342
15/01/2018;14;RR;913765;2730937;-1817172
15/01/2018;42;SC;594543194;1265394579;-670851385
15/01/2018;35;SP;3641541333;5507693787;-1866152454
15/01/2018;28;SE;7019898;12265393;-5245495
15/01/2018;17;TO;11126160;26524902;-15398742
15/02/2018;12;AC;4476594;75715;4400879
15/02/2018;27;AL;46653456;61245773;-14592317
15/02/2018;16;AP;5583041;15552089;-9969048
15/02/2018;13;AM;57206366;777849481;-720643115
15/02/2018;29;BA;608249221;359084761;249164460
15/02/2018;23;CE;156313776;205611039;-49297263
15/02/2018;53;DF;41909695;78669038;-36759343
15/02/2018;32;ES;464109192;301339653;162769539
15/02/2018;52;GO;403633477;294644024;108989453
15/02/2018;21;MA;230360789;236982285;-6621496
15/02/2018;51;MT;982592364;81705227;900887137
15/02/2018;50;MS;336759073;197468687;139290386
15/02/2018;31;MG;1665521036;681999312;983521724
15/02/2018;15;PA;1042407837;95919323;946488514
15/02/2018;25;PB;6427920;36209403;-29781483
15/02/2018;41;PR;1201067602;933675609;267391993
15/02/2018;26;PE;157184510;589939723;-432755213
15/02/2018;22;PI;14732365;12003680;2728685
15/02/2018;33;RJ;1705880751;1117204940;588675811
15/02/2018;24;RN;35460154;9311615;26148539
15/02/2018;43;RS;1443939075;895749077;548189998
15/02/2018;11;RO;94862200;87905581;6956619
15/02/2018;14;RR;2217209;562006;1655203
15/02/2018;42;SC;598024780;1172540182;-574515402
15/02/2018;35;SP;4004367550;4854682293;-850314743
15/02/2018;28;SE;8162618;17797075;-9634457
15/02/2018;17;TO;17349133;20446835;-3097702
15/03/2018;12;AC;3329342;31815;3297527
15/03/2018;27;AL;41355453;63442170;-22086717
15/03/2018;16;AP;17978730;20516459;-2537729
15/03/2018;13;AM;66371553;993033174;-926661621
15/03/2018;29;BA;696708055;496348938;200359117
15/03/2018;23;CE;152188634;212501618;-60312984
15/03/2018;53;DF;19403736;65518731;-46114995
15/03/2018;32;ES;712833635;443287030;269546605
15/03/2018;52;GO;734814430;355526039;379288391
15/03/2018;21;MA;256633353;190743572;65889781
15/03/2018;51;MT;1786880140;83933366;1702946774
15/03/2018;50;MS;533005274;203292434;329712840
15/03/2018;31;MG;2096729496;668360152;1428369344
15/03/2018;15;PA;1194677957;98066514;1096611443
15/03/2018;25;PB;6227601;34712363;-28484762
15/03/2018;41;PR;1594176786;1158949393;435227393
15/03/2018;26;PE;313758587;553247294;-239488707
15/03/2018;22;PI;13496540;11528551;1967989
15/03/2018;33;RJ;1630992577;1359286783;271705794
15/03/2018;24;RN;23191235;8572749;14618486
15/03/2018;43;RS;1565497340;916277067;649220273
15/03/2018;11;RO;155887556;83195957;72691599
15/03/2018;14;RR;3881026;485584;3395442
15/03/2018;42;SC;774141081;1230890997;-456749916
15/03/2018;35;SP;5055430488;5241499940;-186069452
15/03/2018;28;SE;8109401;14391138;-6281737
15/03/2018;17;TO;76474153;14836898;61637255
15/04/2018;12;AC;2219244;1627386;591858
15/04/2018;27;AL;29227847;37167800;-7939953
15/04/2018;16;AP;22787121;25968806;-3181685
15/04/2018;13;AM;59736975;860413086;-800676111
15/04/2018;29;BA;609444183;605859213;3584970
15/04/2018;23;CE;150026611;185050168;-35023557
15/04/2018;53;DF;17776922;63961142;-46184220
15/04/2018;32;ES;663816096;497451665;166364431
15/04/2018;52;GO;690831019;226861305;463969714
15/04/2018;21;MA;302946872;295504012;7442860
15/04/2018;51;MT;1625810678;108530710;1517279968
15/04/2018;50;MS;526252732;287505035;238747697
15/04/2018;31;MG;2001270806;758223803;1243047003
15/04/2018;15;PA;1228304892;141627411;1086677481
15/04/2018;25;PB;10432207;54378102;-43945895
15/04/2018;41;PR;1634376497;1210826823;423549674
15/04/2018;26;PE;179751937;453812686;-274060749
15/04/2018;22;PI;33150542;23147087;10003455
15/04/2018;33;RJ;2209442992;1298765514;910677478
15/04/2018;24;RN;14956287;16660426;-1704139
15/04/2018;43;RS;1575346170;808096713;767249457
15/04/2018;11;RO;151649511;66355454;85294057
15/04/2018;14;RR;1009172;624125;385047
15/04/2018;42;SC;702378336;1269579856;-567201520
15/04/2018;35;SP;4403209376;5189868600;-786659224
15/04/2018;28;SE;10599458;10042507;556951
15/04/2018;17;TO;172433121;17155737;155277384
15/05/2018;12;AC;2828840;109008;2719832
15/05/2018;27;AL;23001996;29517253;-6515257
15/05/2018;16;AP;17389595;1270037;16119558
15/05/2018;13;AM;51807702;714222734;-662415032
15/05/2018;29;BA;591063001;418040903;173022098
15/05/2018;23;CE;143792205;296089858;-152297653
15/05/2018;53;DF;31305875;92593496;-61287621
15/05/2018;32;ES;660715315;426360984;234354331
15/05/2018;52;GO;806262839;331797697;474465142
15/05/2018;21;MA;316022136;192086466;123935670
15/05/2018;51;MT;1849405847;99856567;1749549280
15/05/2018;50;MS;598763241;187343825;411419416
15/05/2018;31;MG;1897373375;688097411;1209275964
15/05/2018;15;PA;1327435224;88476332;1238958892
15/05/2018;25;PB;7076349;58919401;-51843052
15/05/2018;41;PR;1523131345;1035927144;487204201
15/05/2018;26;PE;113930082;485517887;-371587805
15/05/2018;22;PI;87938770;13077008;74861762
15/05/2018;33;RJ;1709761946;1366544634;343217312
15/05/2018;24;RN;14668674;11449484;3219190
15/05/2018;43;RS;1742690488;788124833;954565655
15/05/2018;11;RO;107871822;64017777;43854045
15/05/2018;14;RR;744790;1325935;-581145
15/05/2018;42;SC;692359626;1136316891;-443957265
15/05/2018;35;SP;4031717012;5354613596;-1322896584
15/05/2018;28;SE;3627610;6156815;-2529205
15/05/2018;17;TO;244904202;15369995;229534207
15/06/2018;12;AC;1490658;178910;1311748
15/06/2018;27;AL;25932782;65276884;-39344102
15/06/2018;16;AP;19807110;24241980;-4434870
15/06/2018;13;AM;50417203;792801561;-742384358
15/06/2018;29;BA;652449114;516683598;135765516
15/06/2018;23;CE;242786247;210617364;32168883
15/06/2018;53;DF;30941739;48038240;-17096501
15/06/2018;32;ES;614604797;414008446;200596351
15/06/2018;52;GO;707281655;281574375;425707280
15/06/2018;21;MA;496174222;119992817;376181405
15/06/2018;51;MT;1511743699;118505270;1393238429
15/06/2018;50;MS;675683653;231740100;443943553
15/06/2018;31;MG;2023654850;757824696;1265830154
15/06/2018;15;PA;1275296471;72042518;1203253953
15/06/2018;25;PB;7986202;33613175;-25626973
15/06/2018;41;PR;1880954674;1267546830;613407844
15/06/2018;26;PE;198332732;563782850;-365450118
15/06/2018;22;PI;96510735;12812150;83698585
15/06/2018;33;RJ;1783013610;1242706485;540307125
15/06/2018;24;RN;11897571;15833410;-3935839
15/06/2018;43;RS;1453980869;972406677;481574192
15/06/2018;11;RO;107446940;62301909;45145031
15/06/2018;14;RR;713842;785971;-72129
15/06/2018;42;SC;713279010;1363952264;-650673254
15/06/2018;35;SP;4373471074;5655653492;-1282182418
15/06/2018;28;SE;4665290;9238826;-4573536
15/06/2018;17;TO;132643453;16389360;116254093
15/07/2018;12;AC;1538107;188473;1349634
15/07/2018;27;AL;3153905;43148356;-39994451
15/07/2018;16;AP;14079902;2512685;11567217
15/07/2018;13;AM;34637177;814598759;-779961582
15/07/2018;29;BA;820168425;1108298466;-288130041
15/07/2018;23;CE;246479022;275592143;-29113121
15/07/2018;53;DF;22969017;115836298;-92867281
15/07/2018;32;ES;602629693;389955092;212674601
15/07/2018;52;GO;703057167;315866665;387190502
15/07/2018;21;MA;385985662;219469305;166516357
15/07/2018;51;MT;1758357888;155243566;1603114322
15/07/2018;50;MS;586537767;215798756;370739011
15/07/2018;31;MG;1985040346;780685686;1204354660
15/07/2018;15;PA;1558030335;78486090;1479544245
15/07/2018;25;PB;6606557;57491991;-50885434
15/07/2018;41;PR;1628154469;1093749567;534404902
15/07/2018;26;PE;129838663;655924492;-526085829
15/07/2018;22;PI;95278800;6006392;89272408
15/07/2018;33;RJ;3753032778;2896175292;856857486
15/07/2018;24;RN;14500191;16532813;-2032622
15/07/2018;43;RS;1399267613;1240572102;158695511
15/07/2018;11;RO;137805391;72434515;65370876
15/07/2018;14;RR;565867;264940;300927
15/07/2018;42;SC;891170908;1365380532;-474209624
15/07/2018;35;SP;3799209159;5647979643;-1848770484
15/07/2018;28;SE;6329056;36625793;-30296737
15/07/2018;17;TO;164422914;18642982;145779932
15/08/2018;12;AC;2458645;106574;2352071
15/08/2018;27;AL;181065507;46521123;134544384
15/08/2018;16;AP;25509080;2014978;23494102
15/08/2018;13;AM;48804357;934227384;-885423027
15/08/2018;29;BA;866880180;910095118;-43214938
15/08/2018;23;CE;144323129;221957572;-77634443
15/08/2018;53;DF;27684878;67480021;-39795143
15/08/2018;32;ES;614040644;473488589;140552055
15/08/2018;52;GO;792721118;300861530;491859588
15/08/2018;21;MA;355658017;219199153;136458864
15/08/2018;51;MT;1334298019;211238859;1123059160
15/08/2018;50;MS;527236687;263472305;263764382
15/08/2018;31;MG;2043354618;1041758528;1001596090
15/08/2018;15;PA;1303071047;70114862;1232956185
15/08/2018;25;PB;9358276;33264957;-23906681
15/08/2018;41;PR;1740319972;1561459650;178860322
15/08/2018;26;PE;157835836;559481277;-401645441
15/08/2018;22;PI;120458690;4165088;116293602
15/08/2018;33;RJ;1945882783;3895012829;-1949130046
15/08/2018;24;RN;16041200;12610352;3430848
15/08/2018;43;RS;1667236102;931773001;735463101
15/08/2018;11;RO;105897597;76528517;29369080
15/08/2018;14;RR;1032697;689369;343328
15/08/2018;42;SC;977754291;1499959832;-522205541
15/08/2018;35;SP;4831271644;6245074794;-1413803150
15/08/2018;28;SE;5760418;33579983;-27819565
15/08/2018;17;TO;159262540;13652806;145609734
15/09/2018;12;AC;2038578;125228;1913350
15/09/2018;27;AL;13425015;45532676;-32107661
15/09/2018;16;AP;15327780;24978521;-9650741
15/09/2018;13;AM;73891425;843860243;-769968818
15/09/2018;29;BA;795219239;716605172;78614067
15/09/2018;23;CE;134086088;190588738;-56502650
15/09/2018;53;DF;14847799;76044500;-61196701
15/09/2018;32;ES;985541180;391213813;594327367
15/09/2018;52;GO;609643394;335613564;274029830
15/09/2018;21;MA;332033648;138522611;193511037
15/09/2018;51;MT;1112842937;147045833;965797104
15/09/2018;50;MS;392294484;238397266;153897218
15/09/2018;31;MG;1943409574;787098282;1156311292
15/09/2018;15;PA;1274161381;74290522;1199870859
15/09/2018;25;PB;8886878;46359745;-37472867
15/09/2018;41;PR;1406605866;1279151390;127454476
15/09/2018;26;PE;96916008;441391337;-344475329
15/09/2018;22;PI;50474154;6142052;44332102
15/09/2018;33;RJ;2815616721;1435982024;1379634697
15/09/2018;24;RN;21955599;14655191;7300408
15/09/2018;43;RS;1319110693;980941594;338169099
15/09/2018;11;RO;97628103;63836158;33791945
15/09/2018;14;RR;1371813;327934;1043879
15/09/2018;42;SC;825363621;1250601972;-425238351
15/09/2018;35;SP;4509986568;5244736042;-734749474
15/09/2018;28;SE;5829878;22517494;-16687616
15/09/2018;17;TO;50720918;20093122;30627796
15/10/2018;12;AC;2153366;45763;2107603
15/10/2018;27;AL;1616154;52196513;-50580359
15/10/2018;16;AP;46627910;26591199;20036711
15/10/2018;13;AM;79678643;871852288;-792173645
15/10/2018;29;BA;797523902;670130525;127393377
15/10/2018;23;CE;328323834;207875564;120448270
15/10/2018;53;DF;18280863;127970540;-109689677
15/10/2018;32;ES;898981416;408583587;490397829
15/10/2018;52;GO;567328523;291861520;275467003
15/10/2018;21;MA;429554851;353917108;75637743
15/10/2018;51;MT;1109199435;172206665;936992770
15/10/2018;50;MS;396405680;252483090;143922590
15/10/2018;31;MG;2251362319;817259795;1434102524
15/10/2018;15;PA;1446468400;91579434;1354888966
15/10/2018;25;PB;7222524;63753038;-56530514
15/10/2018;41;PR;1581705249;1200234325;381470924
15/10/2018;26;PE;133922400;452496623;-318574223
15/10/2018;22;PI;84266011;7394669;76871342
15/10/2018;33;RJ;3627261161;1783343223;1843917938
15/10/2018;24;RN;27572822;19342100;8230722
15/10/2018;43;RS;1671119879;1123602307;547517572
15/10/2018;11;RO;71414604;80399242;-8984638
15/10/2018;14;RR;892972;498031;394941
15/10/2018;42;SC;885199477;1470964469;-585764992
15/10/2018;35;SP;4939617715;6208048872;-1268431157
15/10/2018;28;SE;3876882;9376072;-5499190
15/10/2018;17;TO;83601064;20654774;62946290
15/11/2018;12;AC;2886433;80191;2806242
15/11/2018;27;AL;52516309;56134677;-3618368
15/11/2018;16;AP;32777211;2528658;30248553
15/11/2018;13;AM;47725907;808691690;-760965783
15/11/2018;29;BA;891448636;712625652;178822984
15/11/2018;23;CE;191479779;165493363;25986416
15/11/2018;53;DF;7605865;92681681;-85075816
15/11/2018;32;ES;885861837;486642710;399219127
15/11/2018;52;GO;483794310;292182900;191611410
15/11/2018;21;MA;190344041;230579695;-40235654
15/11/2018;51;MT;1232176478;172731568;1059444910
15/11/2018;50;MS;505837692;269470827;236366865
15/11/2018;31;MG;2204076972;780182583;1423894389
15/11/2018;15;PA;1348750993;149667292;1199083701
15/11/2018;25;PB;19791630;58647058;-38855428
15/11/2018;41;PR;1568133816;1279468508;288665308
15/11/2018;26;PE;227633328;811276767;-583643439
15/11/2018;22;PI;34526108;15051730;19474378
15/11/2018;33;RJ;2326631507;1186961566;1139669941
15/11/2018;24;RN;29582851;18559021;11023830
15/11/2018;43;RS;1452449898;1039373137;413076761
15/11/2018;11;RO;85405338;85871424;-466086
15/11/2018;14;RR;1173574;557990;615584
15/11/2018;42;SC;791337658;1355241851;-563904193
15/11/2018;35;SP;4304589802;5272775779;-968185977
15/11/2018;28;SE;5271700;12630642;-7358942
15/11/2018;17;TO;45295990;31644507;13651483
15/12/2018;12;AC;10393330;119516;10273814
15/12/2018;27;AL;42708936;38203344;4505592
15/12/2018;16;AP;16520110;18305763;-1785653
15/12/2018;13;AM;38103179;574690946;-536587767
15/12/2018;29;BA;988635510;805850575;182784935
15/12/2018;23;CE;271736915;167519570;104217345
15/12/2018;53;DF;14350129;102449303;-88099174
15/12/2018;32;ES;842259914;363436754;478823160
15/12/2018;52;GO;577156663;325466176;251690487
15/12/2018;21;MA;284415805;635364071;-350948266
15/12/2018;51;MT;1240184251;174018425;1066165826
15/12/2018;50;MS;352621319;208271786;144349533
15/12/2018;31;MG;2193826093;683037269;1510788824
15/12/2018;15;PA;1361848918;82938056;1278910862
15/12/2018;25;PB;11205146;33997687;-22792541
15/12/2018;41;PR;1297555010;1022207251;275347759
15/12/2018;26;PE;151242267;391421743;-240179476
15/12/2018;22;PI;67557827;12578600;54979227
15/12/2018;33;RJ;2046503822;1140868136;905635686
15/12/2018;24;RN;38749088;8989219;29759869
15/12/2018;43;RS;1626774718;950953653;675821065
15/12/2018;11;RO;75657615;70750036;4907579
15/12/2018;14;RR;1417400;1683601;-266201
15/12/2018;42;SC;826280420;1050289714;-224009294
15/12/2018;35;SP;4619761510;4627655136;-7893626
15/12/2018;28;SE;4739921;7721296;-2981375
15/12/2018;17;TO;46163291;14162804;32000487
15/01/2019;12;AC;3776694;360685;3416009
15/01/2019;27;AL;31318324;43398616;-12080292
15/01/2019;16;AP;20598510;7163773;13434737
15/01/2019;13;AM;54714263;922255735;-867541472
15/01/2019;29;BA;661090189;601168566;59921623
15/01/2019;23;CE;238182551;206104048;32078503
15/01/2019;53;DF;6502296;89394454;-82892158
15/01/2019;32;ES;843804473;511129333;332675140
15/01/2019;52;GO;433689710;266542148;167147562
15/01/2019;21;MA;356937864;198676543;158261321
15/01/2019;51;MT;1093073933;181195243;911878690
15/01/2019;50;MS;359785839;178490274;181295565
15/01/2019;31;MG;2119529190;797957293;1321571897
15/01/2019;15;PA;1170498291;100812158;1069686133
15/01/2019;25;PB;9347546;31999000;-22651454
15/01/2019;41;PR;1099866197;1089675944;10190253
15/01/2019;26;PE;85193267;772901919;-687708652
15/01/2019;22;PI;31331383;4452385;26878998
15/01/2019;33;RJ;2242178830;3370876895;-1128698065
15/01/2019;24;RN;44451482;12579153;31872329
15/01/2019;43;RS;1466459914;755478667;710981247
15/01/2019;11;RO;63124354;82088868;-18964514
15/01/2019;14;RR;13886643;2758544;11128099
15/01/2019;42;SC;599737480;1479049259;-879311779
15/01/2019;35;SP;3480316894;5596529759;-2116212865
15/01/2019;28;SE;6155790;11019859;-4864069
15/01/2019;17;TO;35419459;18860080;16559379
15/02/2019;12;AC;3375210;187514;3187696
15/02/2019;27;AL;33035666;40195905;-7160239
15/02/2019;16;AP;16374438;2465732;13908706
15/02/2019;13;AM;52203324;760470102;-708266778
15/02/2019;29;BA;585018064;603747695;-18729631
15/02/2019;23;CE;155752630;149879397;5873233
15/02/2019;53;DF;9821390;94158849;-84337459
15/02/2019;32;ES;478783811;393023748;85760063
15/02/2019;52;GO;540062992;344189060;195873932
15/02/2019;21;MA;146380333;219794716;-73414383
15/02/2019;51;MT;1501289857;176793605;1324496252
15/02/2019;50;MS;350852985;230375857;120477128
15/02/2019;31;MG;1907142815;698197039;1208945776
15/02/2019;15;PA;1040686337;76077654;964608683
15/02/2019;25;PB;12770336;30554012;-17783676
15/02/2019;41;PR;1134128612;1107665347;26463265
15/02/2019;26;PE;102996218;330835230;-227839012
15/02/2019;22;PI;9002109;13574754;-4572645
15/02/2019;33;RJ;1660890757;1066032640;594858117
15/02/2019;24;RN;46929561;10583711;36345850
15/02/2019;43;RS;1029470242;860176125;169294117
15/02/2019;11;RO;105603881;76328191;29275690
15/02/2019;14;RR;5012387;203754;4808633
15/02/2019;42;SC;711408139;1320741833;-609333694
15/02/2019;35;SP;3920507164;4820328505;-899821341
15/02/2019;28;SE;6317192;13534742;-7217550
15/02/2019;17;TO;23702027;13220725;10481302
15/03/2019;12;AC;2604441;83865;2520576
15/03/2019;27;AL;15759814;41283294;-25523480
15/03/2019;16;AP;20279012;3212951;17066061
15/03/2019;13;AM;60531606;875787494;-815255888
15/03/2019;29;BA;523626710;689115340;-165488630
15/03/2019;23;CE;164552015;117813473;46738542
15/03/2019;53;DF;11682126;49732564;-38050438
15/03/2019;32;ES;587747585;463844629;123902956
15/03/2019;52;GO;630151467;275650224;354501243
15/03/2019;21;MA;196862358;155521684;41340674
15/03/2019;51;MT;1736015473;113995111;1622020362
15/03/2019;50;MS;571902495;232133581;339768914
15/03/2019;31;MG;1983336026;735931024;1247405002
15/03/2019;15;PA;975345668;83149079;892196589
15/03/2019;25;PB;6496299;40814880;-34318581
15/03/2019;41;PR;1378955143;1214203701;164751442
15/03/2019;26;PE;97321491;470983518;-373662027
15/03/2019;22;PI;16161945;12846666;3315279
15/03/2019;33;RJ;2153059653;1247391439;905668214
15/03/2019;24;RN;18524077;11159401;7364676
15/03/2019;43;RS;1185027381;815871913;369155468
15/03/2019;11;RO;184775845;121480532;63295313
15/03/2019;14;RR;2487614;663842;1823772
15/03/2019;42;SC;780426565;1260223210;-479796645
15/03/2019;35;SP;3807227336;4871321386;-1064094050
15/03/2019;28;SE;5463543;27627293;-22163750
15/03/2019;17;TO;99512134;7402547;92109587
15/04/2019;12;AC;2821701;150167;2671534
15/04/2019;27;AL;22707868;48996191;-26288323
15/04/2019;16;AP;14213680;44553497;-30339817
15/04/2019;13;AM;44611980;870336822;-825724842
15/04/2019;29;BA;616903392;590921610;25981782
15/04/2019;23;CE;178339522;196581904;-18242382
15/04/2019;53;DF;14789953;77478629;-62688676
15/04/2019;32;ES;513994152;393436904;120557248
15/04/2019;52;GO;574674342;268854476;305819866
15/04/2019;21;MA;387676152;396457511;-8781359
15/04/2019;51;MT;1554437606;165754665;1388682941
15/04/2019;50;MS;422110466;161911179;260199287
15/04/2019;31;MG;1970707268;717293368;1253413900
15/04/2019;15;PA;898319750;121187386;777132364
15/04/2019;25;PB;6583144;33003188;-26420044
15/04/2019;41;PR;1391988900;1246216752;145772148
15/04/2019;26;PE;104631867;489260784;-384628917
15/04/2019;22;PI;32330310;18689563;13640747
15/04/2019;33;RJ;3237091910;1111721095;2125370815
15/04/2019;24;RN;17714205;14123251;3590954
15/04/2019;43;RS;1281520513;573788663;707731850
15/04/2019;11;RO;145203648;63212829;81990819
15/04/2019;14;RR;2910579;303734;2606845
15/04/2019;42;SC;814417473;1292623362;-478205889
15/04/2019;35;SP;4494229494;5594102536;-1099873042
15/04/2019;28;SE;4748268;37088789;-32340521
15/04/2019;17;TO;125407990;10018106;115389884
15/05/2019;12;AC;2073014;131484;1941530
15/05/2019;27;AL;39948713;45427590;-5478877
15/05/2019;16;AP;17632210;3543639;14088571
15/05/2019;13;AM;52550257;901301795;-848751538
15/05/2019;29;BA;805242533;591729568;213512965
15/05/2019;23;CE;216116401;257807339;-41690938
15/05/2019;53;DF;12359493;127046257;-114686764
15/05/2019;32;ES;581520347;534913985;46606362
15/05/2019;52;GO;590137054;315345103;274791951
15/05/2019;21;MA;397648509;391949146;5699363
15/05/2019;51;MT;1702780151;214069335;1488710816
15/05/2019;50;MS;469544681;166889733;302654948
15/05/2019;31;MG;2298307437;757941954;1540365483
15/05/2019;15;PA;1612259031;95238659;1517020372
15/05/2019;25;PB;9678647;109605751;-99927104
15/05/2019;41;PR;1451338206;1242693501;208644705
15/05/2019;26;PE;121351898;548149125;-426797227
15/05/2019;22;PI;55038981;10471833;44567148
15/05/2019;33;RJ;2478306418;1421110302;1057196116
15/05/2019;24;RN;63706099;16562168;47143931
15/05/2019;43;RS;1611338226;698378043;912960183
15/05/2019;11;RO;156822930;70786252;86036678
15/05/2019;14;RR;6596881;307206;6289675
15/05/2019;42;SC;901419523;1448405234;-546985711
15/05/2019;35;SP;4484916730;5745883011;-1260966281
15/05/2019;28;SE;4466743;267224978;-262758235
15/05/2019;17;TO;181085342;17920644;163164698
15/06/2019;12;AC;2562321;182512;2379809
15/06/2019;27;AL;26053576;39525172;-13471596
15/06/2019;16;AP;15443567;17397103;-1953536
15/06/2019;13;AM;58054543;808119630;-750065087
15/06/2019;29;BA;695072363;414351940;280720423
15/06/2019;23;CE;177462107;169602227;7859880
15/06/2019;53;DF;14048304;63937278;-49888974
15/06/2019;32;ES;625870270;434092682;191777588
15/06/2019;52;GO;559303642;269674836;289628806
15/06/2019;21;MA;284890204;212651729;72238475
15/06/2019;51;MT;1414634458;156539252;1258095206
15/06/2019;50;MS;472534373;167481813;305052560
15/06/2019;31;MG;2174597424;695478077;1479119347
15/06/2019;15;PA;1679014875;114715064;1564299811
15/06/2019;25;PB;9237824;44253941;-35016117
15/06/2019;41;PR;1518823170;1136420058;382403112
15/06/2019;26;PE;94538013;379838235;-285300222
15/06/2019;22;PI;46952901;7216781;39736120
15/06/2019;33;RJ;1902956324;1229266658;673689666
15/06/2019;24;RN;13918111;13061242;856869
15/06/2019;43;RS;1360601468;838260543;522340925
15/06/2019;11;RO;115936555;68992960;46943595
15/06/2019;14;RR;9513299;403842;9109457
15/06/2019;42;SC;749874546;1293158906;-543284360
15/06/2019;35;SP;3949507210;4977325480;-1027818270
15/06/2019;28;SE;3927572;249767692;-245840120
15/06/2019;17;TO;108346967;11020263;97326704
15/07/2019;12;AC;2177823;107168;2070655
15/07/2019;27;AL;19948975;66507289;-46558314
15/07/2019;16;AP;22265364;2781765;19483599
15/07/2019;13;AM;55938051;930062378;-874124327
15/07/2019;29;BA;646623863;749293792;-102669929
15/07/2019;23;CE;258509760;290598123;-32088363
15/07/2019;53;DF;16958883;120844031;-103885148
15/07/2019;32;ES;568416681;571648682;-3232001
15/07/2019;52;GO;667664327;349834846;317829481
15/07/2019;21;MA;386467693;340380003;46087690
15/07/2019;51;MT;1574594472;137472763;1437121709
15/07/2019;50;MS;493479440;167493599;325985841
15/07/2019;31;MG;2143348861;853132697;1290216164
15/07/2019;15;PA;2207793177;109626109;2098167068
15/07/2019;25;PB;10193091;53269356;-43076265
15/07/2019;41;PR;1552895317;1332021798;220873519
15/07/2019;26;PE;144544675;604773221;-460228546
15/07/2019;22;PI;47404347;3905886;43498461
15/07/2019;33;RJ;1976461655;2382197441;-405735786
15/07/2019;24;RN;22800302;13657318;9142984
15/07/2019;43;RS;1747505773;1263587194;483918579
15/07/2019;11;RO;116842476;78572033;38270443
15/07/2019;14;RR;11820770;1243371;10577399
15/07/2019;42;SC;797197556;1472821039;-675623483
15/07/2019;35;SP;4123844063;5968050763;-1844206700
15/07/2019;28;SE;3379031;11640111;-8261080
15/07/2019;17;TO;120582596;24141648;96440948
15/08/2019;12;AC;2527571;183208;2344363
15/08/2019;27;AL;1988910;72496058;-70507148
15/08/2019;16;AP;27043923;6141506;20902417
15/08/2019;13;AM;64978560;862118900;-797140340
15/08/2019;29;BA;658952013;565832833;93119180
15/08/2019;23;CE;146468885;212580779;-66111894
15/08/2019;53;DF;13914814;81805494;-67890680
15/08/2019;32;ES;689883418;453796654;236086764
15/08/2019;52;GO;614426434;292243622;322182812
15/08/2019;21;MA;275276558;259236285;16040273
15/08/2019;51;MT;1294394172;181181873;1113212299
15/08/2019;50;MS;474254405;182174285;292080120
15/08/2019;31;MG;2441814073;792462444;1649351629
15/08/2019;15;PA;2139867591;134631843;2005235748
15/08/2019;25;PB;13949812;40101784;-26151972
15/08/2019;41;PR;1445406089;1376717933;68688156
15/08/2019;26;PE;94575855;520609475;-426033620
15/08/2019;22;PI;76603240;43058056;33545184
15/08/2019;33;RJ;2313971628;3117791357;-803819729
15/08/2019;24;RN;15421214;17883337;-2462123
15/08/2019;43;RS;1539606685;968647805;570958880
15/08/2019;11;RO;105179383;70451263;34728120
15/08/2019;14;RR;9889876;521901;9367975
15/08/2019;42;SC;752269693;1498457299;-746187606
15/08/2019;35;SP;4066475262;5681659150;-1615183888
15/08/2019;28;SE;2444985;21653612;-19208627
15/08/2019;17;TO;83440785;18847360;64593425
15/09/2019;12;AC;2151004;125064;2025940
15/09/2019;27;AL;10897446;76821098;-65923652
15/09/2019;16;AP;24872384;3801848;21070536
15/09/2019;13;AM;64032504;920555013;-856522509
15/09/2019;29;BA;827943327;550643176;277300151
15/09/2019;23;CE;173892800;179043100;-5150300
15/09/2019;53;DF;12589786;121098328;-108508542
15/09/2019;32;ES;584306831;428401395;155905436
15/09/2019;52;GO;607924414;299430145;308494269
15/09/2019;21;MA;320984371;281987856;38996515
15/09/2019;51;MT;1216236395;160346242;1055890153
15/09/2019;50;MS;443377641;201086408;242291233
15/09/2019;31;MG;2115008922;777443511;1337565411
15/09/2019;15;PA;1639876665;81653939;1558222726
15/09/2019;25;PB;12604195;59023175;-46418980
15/09/2019;41;PR;1317441394;1225482965;91958429
15/09/2019;26;PE;152071616;568660881;-416589265
15/09/2019;22;PI;70065517;27759424;42306093
15/09/2019;33;RJ;2324605649;1308668010;1015937639
15/09/2019;24;RN;25778176;12295154;13483022
15/09/2019;43;RS;1594839059;968986436;625852623
15/09/2019;11;RO;67648892;56433411;11215481
15/09/2019;14;RR;11316737;305261;11011476
15/09/2019;42;SC;746010383;1525065440;-779055057
15/09/2019;35;SP;4029449836;5369219109;-1339769273
15/09/2019;28;SE;3078713;10397635;-7318922
15/09/2019;17;TO;117345997;15974915;101371082
15/10/2019;12;AC;2512607;108793;2403814
15/10/2019;27;AL;20142734;67617884;-47475150
15/10/2019;16;AP;36939301;3124911;33814390
15/10/2019;13;AM;61859693;938187104;-876327411
15/10/2019;29;BA;888948545;700767650;188180895
15/10/2019;23;CE;225825447;196023428;29802019
15/10/2019;53;DF;20077786;133466736;-113388950
15/10/2019;32;ES;555607339;566649327;-11041988
15/10/2019;52;GO;715928130;372610502;343317628
15/10/2019;21;MA;294764568;327374496;-32609928
15/10/2019;51;MT;1445333963;179510945;1265823018
15/10/2019;50;MS;458761330;194795093;263966237
15/10/2019;31;MG;2229806819;845960805;1383846014
15/10/2019;15;PA;1658201105;129372904;1528828201
15/10/2019;25;PB;10481248;39439834;-28958586
15/10/2019;41;PR;1410856059;1357272245;53583814
15/10/2019;26;PE;166128659;585886689;-419758030
15/10/2019;22;PI;56276257;48919027;7357230
15/10/2019;33;RJ;2385121252;1392130267;992990985
15/10/2019;24;RN;47684465;17537273;30147192
15/10/2019;43;RS;1719278571;1037188784;682089787
15/10/2019;11;RO;74242999;127678979;-53435980
15/10/2019;14;RR;31672554;503977;31168577
15/10/2019;42;SC;689919723;1604132012;-914212289
15/10/2019;35;SP;4030070281;5944556681;-1914486400
15/10/2019;28;SE;2620620;36705291;-34084671
15/10/2019;17;TO;79326850;16501088;62825762
15/11/2019;12;AC;3396995;114772;3282223
15/11/2019;27;AL;65138842;55231829;9907013
15/11/2019;16;AP;23365439;9850849;13514590
15/11/2019;13;AM;80209994;678437808;-598227814
15/11/2019;29;BA;732888996;512074599;220814397
15/11/2019;23;CE;158840223;210607778;-51767555
15/11/2019;53;DF;17684636;63392187;-45707551
15/11/2019;32;ES;522314840;537018593;-14703753
15/11/2019;52;GO;597355317;338335955;259019362
15/11/2019;21;MA;256165231;607795756;-351630525
15/11/2019;51;MT;1290401049;173987747;1116413302
15/11/2019;50;MS;391357601;265877998;125479603
15/11/2019;31;MG;1999083555;796897781;1202185774
15/11/2019;15;PA;1540949252;100067595;1440881657
15/11/2019;25;PB;13834533;46113815;-32279282
15/11/2019;41;PR;1380686669;1064775093;315911576
15/11/2019;26;PE;143169308;484044711;-340875403
15/11/2019;22;PI;72117943;37564865;34553078
15/11/2019;33;RJ;1642561089;1454933956;187627133
15/11/2019;24;RN;33423396;14694897;18728499
15/11/2019;43;RS;1388249737;848438062;539811675
15/11/2019;11;RO;88429296;57762535;30666761
15/11/2019;14;RR;28140607;680922;27459685
15/11/2019;42;SC;679599183;1302774546;-623175363
15/11/2019;35;SP;4151537606;5068364034;-916826428
15/11/2019;28;SE;4657924;11645201;-6987277
15/11/2019;17;TO;79338905;8165229;71173676
15/12/2019;12;AC;2873883;224362;2649521
15/12/2019;27;AL;32148128;68319495;-36171367
15/12/2019;16;AP;22340538;18235074;4105464
15/12/2019;13;AM;81407789;696486568;-615078779
15/12/2019;29;BA;520174283;353823436;166350847
15/12/2019;23;CE;181250433;170900646;10349787
15/12/2019;53;DF;10271512;86847618;-76576106
15/12/2019;32;ES;553135959;485518409;67617550
15/12/2019;52;GO;602081610;255923547;346158063
15/12/2019;21;MA;239569036;159983727;79585309
15/12/2019;51;MT;1382913207;172191927;1210721280
15/12/2019;50;MS;335485755;257549699;77936056
15/12/2019;31;MG;1755907316;742487798;1013419518
15/12/2019;15;PA;1278428810;79011981;1199416829
15/12/2019;25;PB;11123817;44248113;-33124296
15/12/2019;41;PR;1320922472;1025170733;295751739
15/12/2019;26;PE;159822772;463584314;-303761542
15/12/2019;22;PI;29547738;59664485;-30116747
15/12/2019;33;RJ;3307005005;1364365079;1942639926
15/12/2019;24;RN;44502730;14160703;30342027
15/12/2019;43;RS;1333059961;707057392;626002569
15/12/2019;11;RO;80099830;101628333;-21528503
15/12/2019;14;RR;24459472;1386377;23073095
15/12/2019;42;SC;729575512;1405578188;-676002676
15/12/2019;35;SP;4107619768;4377836547;-270216779
15/12/2019;28;SE;3301336;7848980;-4547644
15/12/2019;17;TO;56989405;13191254;43798151
15/01/2020;12;AC;3675319;218741;3456578
15/01/2020;27;AL;59752403;64340097;-4587694
15/01/2020;16;AP;22746509;11218446;11528063
15/01/2020;13;AM;56975339;950229855;-893254516
15/01/2020;29;BA;608297875;417341208;190956667
15/01/2020;23;CE;203670585;257975003;-54304418
15/01/2020;53;DF;9665593;179988931;-170323338
15/01/2020;32;ES;419760654;491891015;-72130361
15/01/2020;52;GO;377314941;324536016;52778925
15/01/2020;21;MA;183139168;266434221;-83295053
15/01/2020;51;MT;964614355;157060962;807553393
15/01/2020;50;MS;355550725;197032145;158518580
15/01/2020;31;MG;1799713893;763877874;1035836019
15/01/2020;15;PA;1591780268;132509939;1459270329
15/01/2020;25;PB;8490509;58430405;-49939896
15/01/2020;41;PR;939959319;1145901506;-205942187
15/01/2020;26;PE;121480315;583324417;-461844102
15/01/2020;22;PI;27338934;44754195;-17415261
15/01/2020;33;RJ;2014342522;3412073858;-1397731336
15/01/2020;24;RN;33574502;13839152;19735350
15/01/2020;43;RS;858604821;699434744;159170077
15/01/2020;11;RO;89485022;53513602;35971420
15/01/2020;14;RR;7461417;631764;6829653
15/01/2020;42;SC;582014285;1505248057;-923233772
15/01/2020;35;SP;3016318563;5315351969;-2299033406
15/01/2020;28;SE;3022573;15479761;-12457188
15/01/2020;17;TO;41413288;8879158;32534130
15/02/2020;12;AC;3239520;129206;3110314
15/02/2020;27;AL;16173241;61032198;-44858957
15/02/2020;16;AP;16875879;9149422;7726457
15/02/2020;13;AM;63856010;804618430;-740762420
15/02/2020;29;BA;587081594;507246681;79834913
15/02/2020;23;CE;138332678;154222941;-15890263
15/02/2020;53;DF;10278870;142737677;-132458807
15/02/2020;32;ES;372949747;368708719;4241028
15/02/2020;52;GO;433364519;263454418;169910101
15/02/2020;21;MA;170475076;255063770;-84588694
15/02/2020;51;MT;1468493047;110570663;1357922384
15/02/2020;50;MS;309416583;241229045;68187538
15/02/2020;31;MG;1577885440;649595929;928289511
15/02/2020;15;PA;1394896707;77334272;1317562435
15/02/2020;25;PB;11839454;45063030;-33223576
15/02/2020;41;PR;1132328271;958847547;173480724
15/02/2020;26;PE;128014291;428480544;-300466253
15/02/2020;22;PI;15241753;24838155;-9596402
15/02/2020;33;RJ;2380493501;2454978753;-74485252
15/02/2020;24;RN;30011860;17859691;12152169
15/02/2020;43;RS;907005406;503702208;403303198
15/02/2020;11;RO;117705787;49516423;68189364
15/02/2020;14;RR;9880330;10462880;-582550
15/02/2020;42;SC;670123322;1319175116;-649051794
15/02/2020;35;SP;3324173798;4252031205;-927857407
15/02/2020;28;SE;4014805;15954678;-11939873
15/02/2020;17;TO;28293826;9942107;18351719
15/03/2020;12;AC;3401202;183818;3217384
15/03/2020;27;AL;46337704;76995910;-30658206
15/03/2020;16;AP;20585032;7343123;13241909
15/03/2020;13;AM;67132758;877015964;-809883206
15/03/2020;29;BA;679020103;464732560;214287543
15/03/2020;23;CE;211639467;256644320;-45004853
15/03/2020;53;DF;14415660;89143375;-74727715
15/03/2020;32;ES;594740352;424500256;170240096
15/03/2020;52;GO;830175463;278673237;551502226
15/03/2020;21;MA;307489394;177657446;129831948
15/03/2020;51;MT;1909051244;164747860;1744303384
15/03/2020;50;MS;526006366;173383398;352622968
15/03/2020;31;MG;1942930480;720030400;1222900080
15/03/2020;15;PA;1104450839;109155317;995295522
15/03/2020;25;PB;11433292;48332300;-36899008
15/03/2020;41;PR;1527326134;1057039594;470286540
15/03/2020;26;PE;129513566;397152647;-267639081
15/03/2020;22;PI;10976567;35826751;-24850184
15/03/2020;33;RJ;2289465721;1680127862;609337859
15/03/2020;24;RN;35530039;14123915;21406124
15/03/2020;43;RS;1119137387;595085901;524051486
15/03/2020;11;RO;199522212;58622971;140899241
15/03/2020;14;RR;9295094;941956;8353138
15/03/2020;42;SC;732012048;1402536577;-670524529
15/03/2020;35;SP;3814033739;5013364973;-1199331234
15/03/2020;28;SE;5224981;15473866;-10248885
15/03/2020;17;TO;153540942;12174293;141366649
15/04/2020;12;AC;2350754;24677;2326077
15/04/2020;27;AL;49261181;41184711;8076470
15/04/2020;16;AP;15055867;15890073;-834206
15/04/2020;13;AM;45234311;686300361;-641066050
15/04/2020;29;BA;540640898;380267753;160373145
15/04/2020;23;CE;126848731;157172093;-30323362
15/04/2020;53;DF;10166052;91273959;-81107907
15/04/2020;32;ES;424531663;340161370;84370293
15/04/2020;52;GO;700234725;200227156;500007569
15/04/2020;21;MA;266819153;114420523;152398630
15/04/2020;51;MT;1909466842;125632004;1783834838
15/04/2020;50;MS;661912870;140504614;521408256
15/04/2020;31;MG;2029632484;651415991;1378216493
15/04/2020;15;PA;1460918103;121799866;1339118237
15/04/2020;25;PB;8191463;42968691;-34777228
15/04/2020;41;PR;1625975307;994696660;631278647
15/04/2020;26;PE;117185473;270906164;-153720691
15/04/2020;22;PI;48096844;24787109;23309735
15/04/2020;33;RJ;2222561757;1092712178;1129849579
15/04/2020;24;RN;9161910;11584324;-2422414
15/04/2020;43;RS;1267587700;560489603;707098097
15/04/2020;11;RO;136337954;34544700;101793254
15/04/2020;14;RR;11476831;3387636;8089195
15/04/2020;42;SC;696464596;1079881598;-383417002
15/04/2020;35;SP;2899516567;4113766648;-1214250081
15/04/2020;28;SE;3724911;12997210;-9272299
15/04/2020;17;TO;210611544;6211785;204399759
15/05/2020;12;AC;3330739;234442;3096297
15/05/2020;27;AL;43041256;46451410;-3410154
15/05/2020;16;AP;23977859;5197093;18780766
15/05/2020;13;AM;52714742;708171449;-655456707
15/05/2020;29;BA;667419179;365370746;302048433
15/05/2020;23;CE;122320174;235729506;-113409332
15/05/2020;53;DF;12799475;87734889;-74935414
15/05/2020;32;ES;400031704;373296148;26735556
15/05/2020;52;GO;945456143;279217426;666238717
15/05/2020;21;MA;288450249;101221267;187228982
15/05/2020;51;MT;1894300063;189936745;1704363318
15/05/2020;50;MS;598844378;103868309;494976069
15/05/2020;31;MG;2243386875;633815098;1609571777
15/05/2020;15;PA;1254999734;85648878;1169350856
15/05/2020;25;PB;6314664;30997181;-24682517
15/05/2020;41;PR;1356493385;808910107;547583278
15/05/2020;26;PE;123032537;215982813;-92950276
15/05/2020;22;PI;73458454;12337925;61120529
15/05/2020;33;RJ;1582647545;923546408;659101137
15/05/2020;24;RN;6614649;10915244;-4300595
15/05/2020;43;RS;1389614612;426261056;963353556
15/05/2020;11;RO;131982385;37432146;94550239
15/05/2020;14;RR;11926141;2891466;9034675
15/05/2020;42;SC;721544319;1028939075;-307394756
15/05/2020;35;SP;3212804038;3808661711;-595857673
15/05/2020;28;SE;3285612;22356115;-19070503
15/05/2020;17;TO;227131469;9735100;217396369
15/06/2020;12;AC;2218103;152365;2065738
15/06/2020;27;AL;11120411;40482032;-29361621
15/06/2020;16;AP;31003641;17190466;13813175
15/06/2020;13;AM;68301173;617263593;-548962420
15/06/2020;29;BA;595178359;378819721;216358638
15/06/2020;23;CE;148206307;144436827;3769480
15/06/2020;53;DF;23545683;130054463;-106508780
15/06/2020;32;ES;340513969;431361863;-90847894
15/06/2020;52;GO;876325915;257948570;618377345
15/06/2020;21;MA;366747372;95248272;271499100
15/06/2020;51;MT;1840485351;127676789;1712808562
15/06/2020;50;MS;601924274;109531184;492393090
15/06/2020;31;MG;2166162433;634183620;1531978813
15/06/2020;15;PA;1527725903;85493662;1442232241
15/06/2020;25;PB;4481735;30331291;-25849556
15/06/2020;41;PR;1420674731;754600214;666074517
15/06/2020;26;PE;117891013;246406777;-128515764
15/06/2020;22;PI;60441713;9232566;51209147
15/06/2020;33;RJ;1516403181;1090178452;426224729
15/06/2020;24;RN;19137783;14281704;4856079
15/06/2020;43;RS;1380171189;678995901;701175288
15/06/2020;11;RO;136349985;28389730;107960255
15/06/2020;14;RR;15150292;6458750;8691542
15/06/2020;42;SC;615270637;888179494;-272908857
15/06/2020;35;SP;3297099008;4008124866;-711025858
15/06/2020;28;SE;2189025;12488211;-10299186
15/06/2020;17;TO;153935465;11795745;142139720
15/07/2020;12;AC;3257144;314327;2942817
15/07/2020;27;AL;2330951;47318871;-44987920
15/07/2020;16;AP;33764953;17182917;16582036
15/07/2020;13;AM;80100714;744013686;-663912972
15/07/2020;29;BA;766142873;265279695;500863178
15/07/2020;23;CE;169843661;215764796;-45921135
15/07/2020;53;DF;17384421;157903726;-140519305
15/07/2020;32;ES;376954845;377640899;-686054
15/07/2020;52;GO;859556733;263041130;596515603
15/07/2020;21;MA;331759527;126645193;205114334
15/07/2020;51;MT;1661515114;149983808;1511531306
15/07/2020;50;MS;548120969;151190162;396930807
15/07/2020;31;MG;2185232832;647526701;1537706131
15/07/2020;15;PA;2015030793;111746521;1903284272
15/07/2020;25;PB;7874373;33316825;-25442452
15/07/2020;41;PR;1592287868;1025877764;566410104
15/07/2020;26;PE;155932844;216233885;-60301041
15/07/2020;22;PI;64184473;14459026;49725447
15/07/2020;33;RJ;2229100991;938687388;1290413603
15/07/2020;24;RN;8090459;17778888;-9688429
15/07/2020;43;RS;1604389712;760445401;843944311
15/07/2020;11;RO;136346130;39199639;97146491
15/07/2020;14;RR;15458006;813143;14644863
15/07/2020;42;SC;726081729;1069908868;-343827139
15/07/2020;35;SP;3521004347;4282062503;-761058156
15/07/2020;28;SE;2776498;4238098;-1461600
15/07/2020;17;TO;136881924;8042397;128839527
15/08/2020;12;AC;2418285;460417;1957868
15/08/2020;27;AL;5148434;44522736;-39374302
15/08/2020;16;AP;24499476;31344695;-6845219
15/08/2020;13;AM;52028656;828433700;-776405044
15/08/2020;29;BA;513695338;307301702;206393636
15/08/2020;23;CE;155416491;170720771;-15304280
15/08/2020;53;DF;17960923;80310826;-62349903
15/08/2020;32;ES;396667058;462383368;-65716310
15/08/2020;52;GO;763852439;279903677;483948762
15/08/2020;21;MA;302803010;189959114;112843896
15/08/2020;51;MT;1396144987;108574511;1287570476
15/08/2020;50;MS;522562125;140529746;382032379
15/08/2020;31;MG;2289338170;623836253;1665501917
15/08/2020;15;PA;1767281104;81242625;1686038479
15/08/2020;25;PB;7533800;37807440;-30273640
15/08/2020;41;PR;1395804296;894804048;501000248
15/08/2020;26;PE;84198820;257096922;-172898102
15/08/2020;22;PI;70969364;12075643;58893721
15/08/2020;33;RJ;1615596189;898536236;717059953
15/08/2020;24;RN;12518737;12809882;-291145
15/08/2020;43;RS;1364200878;647932273;716268605
15/08/2020;11;RO;95905856;34581352;61324504
15/08/2020;14;RR;14350955;1085429;13265526
15/08/2020;42;SC;732948677;1161509749;-428561072
15/08/2020;35;SP;3602887339;4123137263;-520249924
15/08/2020;28;SE;3966669;8620879;-4654210
15/08/2020;17;TO;102653213;16788912;85864301
15/09/2020;12;AC;2413131;126781;2286350
15/09/2020;27;AL;3854836;48253500;-44398664
15/09/2020;16;AP;28668702;19320936;9347766
15/09/2020;13;AM;67903679;921068678;-853164999
15/09/2020;29;BA;632494602;487124542;145370060
15/09/2020;23;CE;136964039;195575389;-58611350
15/09/2020;53;DF;14212491;70174828;-55962337
15/09/2020;32;ES;426567857;461796691;-35228834
15/09/2020;52;GO;651038480;252337507;398700973
15/09/2020;21;MA;325779179;147124113;178655066
15/09/2020;51;MT;1321283347;127732753;1193550594
15/09/2020;50;MS;548846403;163296297;385550106
15/09/2020;31;MG;2555868333;680749949;1875118384
15/09/2020;15;PA;2161897670;91545459;2070352211
15/09/2020;25;PB;11143473;27805428;-16661955
15/09/2020;41;PR;1552114107;1002903184;549210923
15/09/2020;26;PE;94194586;327036965;-232842379
15/09/2020;22;PI;77557995;47290771;30267224
15/09/2020;33;RJ;1682819699;1219537011;463282688
15/09/2020;24;RN;26278795;20983647;5295148
15/09/2020;43;RS;1065312312;716113378;349198934
15/09/2020;11;RO;107724264;40968074;66756190
15/09/2020;14;RR;28692397;1091443;27600954
15/09/2020;42;SC;664958840;1411616365;-746657525
15/09/2020;35;SP;3801226515;4489956487;-688729972
15/09/2020;28;SE;2840985;15075376;-12234391
15/09/2020;17;TO;97699336;26919777;70779559
15/10/2020;12;AC;2575608;163242;2412366
15/10/2020;27;AL;63150917;58754557;4396360
15/10/2020;16;AP;41674452;15734010;25940442
15/10/2020;13;AM;85431907;844871532;-759439625
15/10/2020;29;BA;765474565;460847407;304627158
15/10/2020;23;CE;170493301;213690631;-43197330
15/10/2020;53;DF;18552460;71406500;-52854040
15/10/2020;32;ES;403520004;404895058;-1375054
15/10/2020;52;GO;560558734;309758482;250800252
15/10/2020;21;MA;302411680;199110441;103301239
15/10/2020;51;MT;1239190361;180103116;1059087245
15/10/2020;50;MS;403236876;137560928;265675948
15/10/2020;31;MG;2396207747;718662792;1677544955
15/10/2020;15;PA;2176796204;107771383;2069024821
15/10/2020;25;PB;13652018;38291826;-24639808
15/10/2020;41;PR;1308230308;962485750;345744558
15/10/2020;26;PE;137270806;402318082;-265047276
15/10/2020;22;PI;69877427;40462476;29414951
15/10/2020;33;RJ;1646531646;1087322879;559208767
15/10/2020;24;RN;41094085;15070587;26023498
15/10/2020;43;RS;992517091;648093160;344423931
15/10/2020;11;RO;71646125;52664082;18982043
15/10/2020;14;RR;31945114;934382;31010732
15/10/2020;42;SC;622642973;1465948653;-843305680
15/10/2020;35;SP;3933663694;4650985419;-717321725
15/10/2020;28;SE;2920070;6833835;-3913765
15/10/2020;17;TO;82829818;31657381;51172437
15/11/2020;12;AC;2589960;499211;2090749
15/11/2020;27;AL;48010725;66051708;-18040983
15/11/2020;16;AP;26961931;18689063;8272868
15/11/2020;13;AM;79451707;891958357;-812506650
15/11/2020;29;BA;753627099;508268500;245358599
15/11/2020;23;CE;116731212;202374940;-85643728
15/11/2020;53;DF;13533607;103966856;-90433249
15/11/2020;32;ES;318401612;435417503;-117015891
15/11/2020;52;GO;562895762;293611430;269284332
15/11/2020;21;MA;226156409;122209490;103946919
15/11/2020;51;MT;1300167092;163297977;1136869115
15/11/2020;50;MS;402729095;175558702;227170393
15/11/2020;31;MG;2400659265;785968974;1614690291
15/11/2020;15;PA;2098705500;121089775;1977615725
15/11/2020;25;PB;16243417;50871601;-34628184
15/11/2020;41;PR;1380122767;1304742867;75379900
15/11/2020;26;PE;171560656;473477443;-301916787
15/11/2020;22;PI;28079537;20837654;7241883
15/11/2020;33;RJ;1663876476;1158551678;505324798
15/11/2020;24;RN;40965743;15410190;25555553
15/11/2020;43;RS;915189617;703316286;211873331
15/11/2020;11;RO;71521061;66644849;4876212
15/11/2020;14;RR;27256380;2201578;25054802
15/11/2020;42;SC;683859634;1868488637;-1184629003
15/11/2020;35;SP;3816281839;5131873406;-1315591567
15/11/2020;28;SE;2202037;11685985;-9483948
15/11/2020;17;TO;76029187;44194797;31834390
15/12/2020;12;AC;2485268;346271;2138997
15/12/2020;27;AL;70004407;70183823;-179416
15/12/2020;16;AP;26352355;13436055;12916300
15/12/2020;13;AM;67586891;844285075;-776698184
15/12/2020;29;BA;729129230;428596653;300532577
15/12/2020;23;CE;152951229;209241589;-56290360
15/12/2020;53;DF;11661268;127937766;-116276498
15/12/2020;32;ES;488259049;483346597;4912452
15/12/2020;52;GO;573038116;316577495;256460621
15/12/2020;21;MA;299145103;181836747;117308356
15/12/2020;51;MT;1327202076;194716053;1132486023
15/12/2020;50;MS;343264195;171506973;171757222
15/12/2020;31;MG;2732130284;742575720;1989554564
15/12/2020;15;PA;2057288052;74285016;1983003036
15/12/2020;25;PB;18075188;60412094;-42336906
15/12/2020;41;PR;1024466573;966842602;57623971
15/12/2020;26;PE;198593681;553341231;-354747550
15/12/2020;22;PI;37732517;12720534;25011983
15/12/2020;33;RJ;1785874335;2503687399;-717813064
15/12/2020;24;RN;77741068;15731462;62009606
15/12/2020;43;RS;1195898496;664693430;531205066
15/12/2020;11;RO;77339154;71021470;6317684
15/12/2020;14;RR;13947285;1520985;12426300
15/12/2020;42;SC;679783034;1889761950;-1209978916
15/12/2020;35;SP;4286799495;4955442344;-668642849
15/12/2020;28;SE;3102475;9212850;-6110375
15/12/2020;17;TO;57240137;67469397;-10229260
15/01/2021;12;AC;3650904;252056;3398848
15/01/2021;27;AL;2410234;60959223;-58548989
15/01/2021;16;AP;29361742;19432806;9928936
15/01/2021;13;AM;72162735;934731730;-862568995
15/01/2021;29;BA;617659857;682220477;-64560620
15/01/2021;23;CE;106103543;237203020;-131099477
15/01/2021;53;DF;11144842;64744014;-53599172
15/01/2021;32;ES;469560617;434567112;34993505
15/01/2021;52;GO;378966221;461987564;-83021343
15/01/2021;21;MA;219556656;200805286;18751370
15/01/2021;51;MT;1027168304;199376612;827791692
15/01/2021;50;MS;309094756;169838921;139255835
15/01/2021;31;MG;2309976648;801114834;1508861814
15/01/2021;15;PA;2008096387;120800492;1887295895
15/01/2021;25;PB;12460733;41806530;-29345797
15/01/2021;41;PR;848942756;1256972232;-408029476
15/01/2021;26;PE;138962746;403616629;-264653883
15/01/2021;22;PI;10977273;21232270;-10254997
15/01/2021;33;RJ;1796838086;1658484697;138353389
15/01/2021;24;RN;27219700;61225081;-34005381
15/01/2021;43;RS;890537089;624587445;265949644
15/01/2021;11;RO;60914323;65279945;-4365622
15/01/2021;14;RR;14524399;1463731;13060668
15/01/2021;42;SC;488563929;1765816427;-1277252498
15/01/2021;35;SP;3056616251;4800658602;-1744042351
15/01/2021;28;SE;3028804;8739483;-5710679
15/01/2021;17;TO;25828352;69451879;-43623527
15/02/2021;12;AC;2922601;227898;2694703
15/02/2021;27;AL;73802268;61476776;12325492
15/02/2021;16;AP;21615400;16522490;5092910
15/02/2021;13;AM;68411229;945425077;-877013848
15/02/2021;29;BA;453726653;407094760;46631893
15/02/2021;23;CE;132711259;211898002;-79186743
15/02/2021;53;DF;23134100;75203040;-52068940
15/02/2021;32;ES;473995629;395519957;78475672
15/02/2021;52;GO;384006790;472187657;-88180867
15/02/2021;21;MA;284598511;204661460;79937051
15/02/2021;51;MT;1471178838;185498515;1285680323
15/02/2021;50;MS;284562115;245265008;39297107
15/02/2021;31;MG;2309798950;839738964;1470059986
15/02/2021;15;PA;2068932859;81905788;1987027071
15/02/2021;25;PB;9904829;35100491;-25195662
15/02/2021;41;PR;1017866498;1123476580;-105610082
15/02/2021;26;PE;105371837;422701354;-317329517
15/02/2021;22;PI;18505742;12582358;5923384
15/02/2021;33;RJ;1866160538;1416810494;449350044
15/02/2021;24;RN;29224461;15792218;13432243
15/02/2021;43;RS;1002056033;566415585;435640448
15/02/2021;11;RO;85456233;56139018;29317215
15/02/2021;14;RR;26459006;4672431;21786575
15/02/2021;42;SC;633888940;1904059946;-1270171006
15/02/2021;35;SP;3466469803;4821878078;-1355408275
15/02/2021;28;SE;3125988;7006074;-3880086
15/02/2021;17;TO;27736684;9907358;17829326
15/03/2021;12;AC;7101165;455391;6645774
15/03/2021;27;AL;75452339;74856435;595904
15/03/2021;16;AP;23314733;35720812;-12406079
15/03/2021;13;AM;75833090;1095110848;-1019277758
15/03/2021;29;BA;709633505;612675131;96958374
15/03/2021;23;CE;196258598;304818687;-108560089
15/03/2021;53;DF;22568248;182310535;-159742287
15/03/2021;32;ES;805167016;463713019;341453997
15/03/2021;52;GO;1045918018;428110137;617807881
15/03/2021;21;MA;337570820;234183843;103386977
15/03/2021;51;MT;2929048293;157045456;2772002837
15/03/2021;50;MS;635559691;179719500;455840191
15/03/2021;31;MG;3278355281;998044949;2280310332
15/03/2021;15;PA;2401319853;131361571;2269958282
15/03/2021;25;PB;11026162;65844017;-54817855
15/03/2021;41;PR;1700069604;1392302792;307766812
15/03/2021;26;PE;123422869;516277783;-392854914
15/03/2021;22;PI;37145203;24984215;12160988
15/03/2021;33;RJ;2965682182;1694879101;1270803081
15/03/2021;24;RN;17038329;14893468;2144861
15/03/2021;43;RS;1218597678;777945651;440652027
15/03/2021;11;RO;247632113;51239782;196392331
15/03/2021;14;RR;18575856;1874470;16701386
15/03/2021;42;SC;760540306;2246155187;-1485614881
15/03/2021;35;SP;4471934922;6088449767;-1616514845
15/03/2021;28;SE;2694274;13672049;-10977775
15/03/2021;17;TO;170254729;78634268;91620461
15/04/2021;12;AC;6926186;199517;6726669
15/04/2021;27;AL;28738896;80590836;-51851940
15/04/2021;16;AP;23973995;63359516;-39385521
15/04/2021;13;AM;79849506;1014703884;-934854378
15/04/2021;29;BA;853347700;728517202;124830498
15/04/2021;23;CE;219788142;222453284;-2665142
15/04/2021;53;DF;33893309;108844922;-74951613
15/04/2021;32;ES;717486753;487941280;229545473
15/04/2021;52;GO;1122840829;328672417;794168412
15/04/2021;21;MA;399608773;289194288;110414485
15/04/2021;51;MT;2578366726;96463330;2481903396
15/04/2021;50;MS;847121102;147437425;699683677
15/04/2021;31;MG;3274522428;960260631;2314261797
15/04/2021;15;PA;2348727916;122618975;2226108941
15/04/2021;25;PB;9185191;40520382;-31335191
15/04/2021;41;PR;1939360127;1170558115;768802012
15/04/2021;26;PE;271059854;458877948;-187818094
15/04/2021;22;PI;92194066;7783993;84410073
15/04/2021;33;RJ;3064939783;1773388827;1291550956
15/04/2021;24;RN;63059410;20590759;42468651
15/04/2021;43;RS;1893744437;743098780;1150645657
15/04/2021;11;RO;228056639;39791670;188264969
15/04/2021;14;RR;19474882;4562515;14912367
15/04/2021;42;SC;916457715;1864084157;-947626442
15/04/2021;35;SP;4617135273;5288902056;-671766783
15/04/2021;28;SE;7516190;13381262;-5865072
15/04/2021;17;TO;341558162;19511157;322047005
15/05/2021;12;AC;3464354;33506;3430848
15/05/2021;27;AL;20041506;77089294;-57047788
15/05/2021;16;AP;24859495;40368886;-15509391
15/05/2021;13;AM;74355582;1135404322;-1061048740
15/05/2021;29;BA;861071974;542321992;318749982
15/05/2021;23;CE;177215554;303809426;-126593872
15/05/2021;53;DF;22872516;177248740;-154376224
15/05/2021;32;ES;747783820;527638537;220145283
15/05/2021;52;GO;1081836502;335183759;746652743
15/05/2021;21;MA;441078401;284473347;156605054
15/05/2021;51;MT;2663189654;120087186;2543102468
15/05/2021;50;MS;832441497;192534206;639907291
15/05/2021;31;MG;3621975918;1084488402;2537487516
15/05/2021;15;PA;2227712684;104612355;2123100329
15/05/2021;25;PB;9153923;29606043;-20452120
15/05/2021;41;PR;2016187287;1546653265;469534022
15/05/2021;26;PE;238082650;475781672;-237699022
15/05/2021;22;PI;135319146;33831902;101487244
15/05/2021;33;RJ;2347924742;1733321849;614602893
15/05/2021;24;RN;32715154;21989482;10725672
15/05/2021;43;RS;2224611352;941404498;1283206854
15/05/2021;11;RO;154710873;49107384;105603489
15/05/2021;14;RR;21888083;846601;21041482
15/05/2021;42;SC;991280493;2129128317;-1137847824
15/05/2021;35;SP;4948186679;5724786781;-776600102
15/05/2021;28;SE;3227258;9921893;-6694635
15/05/2021;17;TO;259653240;42968597;216684643
15/06/2021;12;AC;4548365;331431;4216934
15/06/2021;27;AL;6646302;49125646;-42479344
15/06/2021;16;AP;26185233;32424821;-6239588
15/06/2021;13;AM;68509429;1179611423;-1111101994
15/06/2021;29;BA;942379712;862245181;80134531
15/06/2021;23;CE;281744401;259470143;22274258
15/06/2021;53;DF;21942444;275568480;-253626036
15/06/2021;32;ES;1005421384;589289207;416132177
15/06/2021;52;GO;992773511;346264902;646508609
15/06/2021;21;MA;436581420;284310667;152270753
15/06/2021;51;MT;2398880574;157081817;2241798757
15/06/2021;50;MS;702371205;207286396;495084809
15/06/2021;31;MG;4061991170;1088238838;2973752332
15/06/2021;15;PA;3205767434;133669339;3072098095
15/06/2021;25;PB;11447136;53838822;-42391686
15/06/2021;41;PR;1652741293;1423093761;229647532
15/06/2021;26;PE;163921455;511752703;-347831248
15/06/2021;22;PI;83764677;37469267;46295410
15/06/2021;33;RJ;4019111350;1488174823;2530936527
15/06/2021;24;RN;14317624;24347544;-10029920
15/06/2021;43;RS;1923726168;1063317655;860408513
15/06/2021;11;RO;191105708;49536853;141568855
15/06/2021;14;RR;17835174;1149687;16685487
15/06/2021;42;SC;861839113;2064478423;-1202639310
15/06/2021;35;SP;4921513219;5619018066;-697504847
15/06/2021;28;SE;3110154;16103030;-12992876
15/06/2021;17;TO;197773498;26401935;171371563
15/07/2021;12;AC;3426319;109279;3317040
15/07/2021;27;AL;1747768;47309270;-45561502
15/07/2021;16;AP;20029211;31566161;-11536950
15/07/2021;13;AM;85804547;1076086230;-990281683
15/07/2021;29;BA;926194030;384818821;541375209
15/07/2021;23;CE;329228574;202657749;126570825
15/07/2021;53;DF;24122797;269087919;-244965122
15/07/2021;32;ES;891358190;619067287;272290903
15/07/2021;52;GO;824355808;368165911;456189897
15/07/2021;21;MA;471679537;344323234;127356303
15/07/2021;51;MT;1913420312;241158111;1672262201
15/07/2021;50;MS;707980481;199493946;508486535
15/07/2021;31;MG;3973127364;1009521518;2963605846
15/07/2021;15;PA;2970614607;90978681;2879635926
15/07/2021;25;PB;11764766;30647588;-18882822
15/07/2021;41;PR;1920890609;1521448176;399442433
15/07/2021;26;PE;233022138;561627581;-328605443
15/07/2021;22;PI;96589196;39323922;57265274
15/07/2021;33;RJ;2294202240;1838568444;455633796
15/07/2021;24;RN;29075413;17858521;11216892
15/07/2021;43;RS;2047867032;1118295603;929571429
15/07/2021;11;RO;184930274;40459300;144470974
15/07/2021;14;RR;21111428;692402;20419026
15/07/2021;42;SC;952248523;2069335913;-1117087390
15/07/2021;35;SP;4341864559;5910910251;-1569045692
15/07/2021;28;SE;4382426;28181424;-23798998
15/07/2021;17;TO;155728834;66947479;88781355
15/08/2021;12;AC;2755500;206350;2549150
15/08/2021;27;AL;2183564;56228763;-54045199
15/08/2021;16;AP;35173393;65607475;-30434082
15/08/2021;13;AM;63158155;1223397008;-1160238853
15/08/2021;29;BA;913886187;622136129;291750058
15/08/2021;23;CE;279455900;329792096;-50336196
15/08/2021;53;DF;25439342;382265122;-356825780
15/08/2021;32;ES;1086746569;505038473;581708096
15/08/2021;52;GO;813203430;497367322;315836108
15/08/2021;21;MA;402135245;426503016;-24367771
15/08/2021;51;MT;1647325270;341359948;1305965322
15/08/2021;50;MS;601020954;253731303;347289651
15/08/2021;31;MG;3921535731;1156843120;2764692611
15/08/2021;15;PA;3535709733;145821690;3389888043
15/08/2021;25;PB;10019596;73945706;-63926110
15/08/2021;41;PR;1682671025;1451760792;230910233
15/08/2021;26;PE;154015916;969006362;-814990446
15/08/2021;22;PI;136754623;14514379;122240244
15/08/2021;33;RJ;3484285346;1758224416;1726060930
15/08/2021;24;RN;14903103;25100141;-10197038
15/08/2021;43;RS;2463417337;1180001464;1283415873
15/08/2021;11;RO;143642676;42418805;101223871
15/08/2021;14;RR;24007443;431863;23575580
15/08/2021;42;SC;863072415;2014614078;-1151541663
15/08/2021;35;SP;4639516448;5965419946;-1325903498
15/08/2021;28;SE;5693384;11666940;-5973556
15/08/2021;17;TO;215901519;43769894;172131625
15/09/2021;12;AC;3723670;95392;3628278
15/09/2021;27;AL;15781129;63712188;-47931059
15/09/2021;16;AP;26818633;29222564;-2403931
15/09/2021;13;AM;65796332;1162276670;-1096480338
15/09/2021;29;BA;1044517521;502404955;542112566
15/09/2021;23;CE;337377801;370168773;-32790972
15/09/2021;53;DF;18298508;482458072;-464159564
15/09/2021;32;ES;856868349;565884986;290983363
15/09/2021;52;GO;763710069;455365008;308345061
15/09/2021;21;MA;369543247;376687647;-7144400
15/09/2021;51;MT;1198775514;440040344;758735170
15/09/2021;50;MS;502217840;229858248;272359592
15/09/2021;31;MG;3155443350;1223992442;1931450908
15/09/2021;15;PA;2903315390;174802411;2728512979
15/09/2021;25;PB;10691527;47417420;-36725893
15/09/2021;41;PR;1685876128;1431086488;254789640
15/09/2021;26;PE;117222504;562772912;-445550408
15/09/2021;22;PI;123397543;105515960;17881583
15/09/2021;33;RJ;2528678406;2174964101;353714305
15/09/2021;24;RN;78692395;26228508;52463887
15/09/2021;43;RS;1953252636;1304799268;648453368
15/09/2021;11;RO;136390770;52292897;84097873
15/09/2021;14;RR;30029569;539748;29489821
15/09/2021;42;SC;974724649;2177192043;-1202467394
15/09/2021;35;SP;5258249212;5948436792;-690187580
15/09/2021;28;SE;5676354;14076786;-8400432
15/09/2021;17;TO;170969053;53154958;117814095
15/10/2021;12;AC;3622557;519800;3102757
15/10/2021;27;AL;51299208;44133175;7166033
15/10/2021;16;AP;25376947;59468069;-34091122
15/10/2021;13;AM;75098272;1182733392;-1107635120
15/10/2021;29;BA;957788748;791195420;166593328
15/10/2021;23;CE;162073811;484879641;-322805830
15/10/2021;53;DF;21505651;450560632;-429054981
15/10/2021;32;ES;780740815;542884899;237855916
15/10/2021;52;GO;572811618;659667553;-86855935
15/10/2021;21;MA;386935636;681734361;-294798725
15/10/2021;51;MT;1051851428;437045661;614805767
15/10/2021;50;MS;435480449;228789944;206690505
15/10/2021;31;MG;2767578971;1228770775;1538808196
15/10/2021;15;PA;2123920773;129105060;1994815713
15/10/2021;25;PB;19328326;70990660;-51662334
15/10/2021;41;PR;1485940757;1443839536;42101221
15/10/2021;26;PE;203713288;655344722;-451631434
15/10/2021;22;PI;51347043;148528693;-97181650
15/10/2021;33;RJ;3463282880;2203928388;1259354492
15/10/2021;24;RN;96554013;35865173;60688840
15/10/2021;43;RS;2125899816;1236597378;889302438
15/10/2021;11;RO;75072818;45193473;29879345
15/10/2021;14;RR;22137403;40520430;-18383027
15/10/2021;42;SC;940242869;2109740051;-1169497182
15/10/2021;35;SP;4430823506;5543687080;-1112863574
15/10/2021;28;SE;39075957;18402379;20673578
15/10/2021;17;TO;126555473;64792083;61763390
15/11/2021;12;AC;2751626;749710;2001916
15/11/2021;27;AL;95945357;67168239;28777118
15/11/2021;16;AP;28042902;11773190;16269712
15/11/2021;13;AM;59229858;1205717520;-1146487662
15/11/2021;29;BA;898965152;905271458;-6306306
15/11/2021;23;CE;242351290;549588058;-307236768
15/11/2021;53;DF;17215518;526190984;-508975466
15/11/2021;32;ES;959268287;710399746;248868541
15/11/2021;52;GO;592904464;723333877;-130429413
15/11/2021;21;MA;278021279;474029136;-196007857
15/11/2021;51;MT;1063926421;410813158;653113263
15/11/2021;50;MS;490814696;250232963;240581733
15/11/2021;31;MG;2667611276;1367685138;1299926138
15/11/2021;15;PA;1834067560;177258847;1656808713
15/11/2021;25;PB;11990517;101447014;-89456497
15/11/2021;41;PR;1500355608;1670393274;-170037666
15/11/2021;26;PE;187022266;497453413;-310431147
15/11/2021;22;PI;29619474;30828641;-1209167
15/11/2021;33;RJ;1966190542;2410549263;-444358721
15/11/2021;24;RN;51825226;32014252;19810974
15/11/2021;43;RS;1550827720;1231014048;319813672
15/11/2021;11;RO;84235186;43122970;41112216
15/11/2021;14;RR;37936841;718717;37218124
15/11/2021;42;SC;976784834;2314745400;-1337960566
15/11/2021;35;SP;4689172077;5799304374;-1110132297
15/11/2021;28;SE;6891630;24154197;-17262567
15/11/2021;17;TO;75046145;75831861;-785716
15/12/2021;12;AC;3944542;560886;3383656
15/12/2021;27;AL;70632115;90233832;-19601717
15/12/2021;16;AP;22246011;18969913;3276098
15/12/2021;13;AM;79739231;1070924805;-991185574
15/12/2021;29;BA;765476552;1012643974;-247167422
15/12/2021;23;CE;274793763;393625314;-118831551
15/12/2021;53;DF;26490370;616931205;-590440835
15/12/2021;32;ES;985962040;684649052;301312988
15/12/2021;52;GO;732831032;547655972;185175060
15/12/2021;21;MA;346821117;381527846;-34706729
15/12/2021;51;MT;1708270486;327542078;1380728408
15/12/2021;50;MS;546173693;283114360;263059333
15/12/2021;31;MG;2998273373;1300321242;1697952131
15/12/2021;15;PA;1897692621;130049066;1767643555
15/12/2021;25;PB;19669370;43420451;-23751081
15/12/2021;41;PR;1583514540;1540717413;42797127
15/12/2021;26;PE;176471590;602904232;-426432642
15/12/2021;22;PI;42084982;44764781;-2679799
15/12/2021;33;RJ;3496334196;2241852502;1254481694
15/12/2021;24;RN;60232538;37830941;22401597
15/12/2021;43;RS;1838884446;956104156;882780290
15/12/2021;11;RO;95037592;59662135;35375457
15/12/2021;14;RR;82645319;2738217;79907102
15/12/2021;42;SC;936340372;2258165342;-1321824970
15/12/2021;35;SP;5222725420;5702940346;-480214926
15/12/2021;28;SE;7832341;6911567;920774
15/12/2021;17;TO;78934437;62704421;16230016
15/01/2022;12;AC;4233029;77352;4155677
15/01/2022;27;AL;54297856;53915716;382140
15/01/2022;16;AP;20237270;30296868;-10059598
15/01/2022;13;AM;60864716;1161274905;-1100410189
15/01/2022;29;BA;939299402;1530392340;-591092938
15/01/2022;23;CE;210014465;629284762;-419270297
15/01/2022;53;DF;18325609;202649406;-184323797
15/01/2022;32;ES;613561286;648847751;-35286465
15/01/2022;52;GO;777635995;554272983;223363012
15/01/2022;21;MA;283472920;595905995;-312433075
15/01/2022;51;MT;1488745873;245365741;1243380132
15/01/2022;50;MS;527632051;196624631;331007420
15/01/2022;31;MG;2417236657;1125365996;1291870661
15/01/2022;15;PA;1454509583;178540841;1275968742
15/01/2022;25;PB;9796595;83229209;-73432614
15/01/2022;41;PR;1302979509;1388247564;-85268055
15/01/2022;26;PE;278749184;490415497;-211666313
15/01/2022;22;PI;37601382;21603934;15997448
15/01/2022;33;RJ;2556942987;2098873564;458069423
15/01/2022;24;RN;60259138;44738964;15520174
15/01/2022;43;RS;1669477605;801174341;868303264
15/01/2022;11;RO;103826743;50213699;53613044
15/01/2022;14;RR;33057178;15574908;17482270
15/01/2022;42;SC;782157058;2238891002;-1456733944
15/01/2022;35;SP;3970045431;5315018906;-1344973475
15/01/2022;28;SE;6566171;80472301;-73906130
15/01/2022;17;TO;68498282;57767719;10730563
15/02/2022;12;AC;4403971;33465;4370506
15/02/2022;27;AL;51621481;98291503;-46670022
15/02/2022;16;AP;25454514;29969881;-4515367
15/02/2022;13;AM;63094798;1054135178;-991040380
15/02/2022;29;BA;606215176;507995720;98219456
15/02/2022;23;CE;177985854;373768848;-195782994
15/02/2022;53;DF;23204641;404519629;-381314988
15/02/2022;32;ES;705411310;692329876;13081434
15/02/2022;52;GO;875671968;421313935;454358033
15/02/2022;21;MA;301563090;250356741;51206349
15/02/2022;51;MT;2762286874;296200995;2466085879
15/02/2022;50;MS;525186458;278487344;246699114
15/02/2022;31;MG;2584667371;1041344890;1543322481
15/02/2022;15;PA;1371285310;194027507;1177257803
15/02/2022;25;PB;12892734;74010218;-61117484
15/02/2022;41;PR;1471607918;1497279467;-25671549
15/02/2022;26;PE;278513999;520303818;-241789819
15/02/2022;22;PI;51710000;4988973;46721027
15/02/2022;33;RJ;3880929536;2368739895;1512189641
15/02/2022;24;RN;83448696;49132411;34316285
15/02/2022;43;RS;1569455231;725544436;843910795
15/02/2022;11;RO;199445128;46909150;152535978
15/02/2022;14;RR;36613864;6644333;29969531
15/02/2022;42;SC;810543420;2137924518;-1327381098
15/02/2022;35;SP;4849093021;5716112859;-867019838
15/02/2022;28;SE;4532264;14209677;-9677413
15/02/2022;17;TO;110535940;79446752;31089188
15/03/2022;12;AC;10282647;244686;10037961
15/03/2022;27;AL;46701128;56857700;-10156572
15/03/2022;16;AP;16487203;28121025;-11633822
15/03/2022;13;AM;59788621;1217197552;-1157408931
15/03/2022;29;BA;1062350301;796286928;266063373
15/03/2022;23;CE;161619202;493595542;-331976340
15/03/2022;53;DF;34444596;246081868;-211637272
15/03/2022;32;ES;757694656;765406056;-7711400
15/03/2022;52;GO;1517843889;516811868;1001032021
15/03/2022;21;MA;503857519;522321794;-18464275
15/03/2022;51;MT;3203863714;422694744;2781168970
15/03/2022;50;MS;878213435;249023766;629189669
15/03/2022;31;MG;3893281394;1302243089;2591038305
15/03/2022;15;PA;1996815769;174536769;1822279000
15/03/2022;25;PB;12645726;143007607;-130361881
15/03/2022;41;PR;1780630827;1806104655;-25473828
15/03/2022;26;PE;173360335;599103800;-425743465
15/03/2022;22;PI;102131782;12877193;89254589
15/03/2022;33;RJ;3666919821;2313550844;1353368977
15/03/2022;24;RN;75945857;31896122;44049735
15/03/2022;43;RS;1760097174;905204838;854892336
15/03/2022;11;RO;349372024;54563455;294808569
15/03/2022;14;RR;34034489;599763;33434726
15/03/2022;42;SC;928419486;2342753507;-1414334021
15/03/2022;35;SP;6025695283;6622587550;-596892267
15/03/2022;28;SE;5713676;93708981;-87995305
15/03/2022;17;TO;322679165;91745218;230933947
15/04/2022;12;AC;6927060;79521;6847539
15/04/2022;27;AL;56584872;52168787;4416085
15/04/2022;16;AP;19341929;4373657;14968272
15/04/2022;13;AM;84891314;1324054360;-1239163046
15/04/2022;29;BA;1564487515;852763907;711723608
15/04/2022;23;CE;248693761;444528121;-195834360
15/04/2022;53;DF;42076386;212442015;-170365629
15/04/2022;32;ES;872841152;693415649;179425503
15/04/2022;52;GO;1424925139;470822205;954102934
15/04/2022;21;MA;540011942;806098622;-266086680
15/04/2022;51;MT;3368717624;427353112;2941364512
15/04/2022;50;MS;767078593;311501906;455576687
15/04/2022;31;MG;3345341552;1303443918;2041897634
15/04/2022;15;PA;1927642656;203736262;1723906394
15/04/2022;25;PB;13613960;108849755;-95235795
15/04/2022;41;PR;1972901362;1758438618;214462744
15/04/2022;26;PE;159638648;465845622;-306206974
15/04/2022;22;PI;161503470;7682018;153821452
15/04/2022;33;RJ;3053161355;1628137463;1425023892
15/04/2022;24;RN;36682714;12168152;24514562
15/04/2022;43;RS;1754236891;1306836540;447400351
15/04/2022;11;RO;275536905;54351181;221185724
15/04/2022;14;RR;24566537;270969;24295568
15/04/2022;42;SC;1053301692;2110980746;-1057679054
15/04/2022;35;SP;5736831652;6114702396;-377870744
15/04/2022;28;SE;10391195;11830731;-1439536
15/04/2022;17;TO;355636900;56066568;299570332
15/05/2022;12;AC;6784580;794724;5989856
15/05/2022;27;AL;77033363;51622514;25410849
15/05/2022;16;AP;11130775;66871826;-55741051
15/05/2022;13;AM;77505628;1188116041;-1110610413
15/05/2022;29;BA;1249191755;1255101209;-5909454
15/05/2022;23;CE;161135924;502442706;-341306782
15/05/2022;53;DF;29295039;189169270;-159874231
15/05/2022;32;ES;1068147482;897324485;170822997
15/05/2022;52;GO;1490570515;565041871;925528644
15/05/2022;21;MA;592719823;800669110;-207949287
15/05/2022;51;MT;3700524442;567848543;3132675899
15/05/2022;50;MS;764889037;336826552;428062485
15/05/2022;31;MG;3819701339;1684218576;2135482763
15/05/2022;15;PA;1863097816;275582281;1587515535
15/05/2022;25;PB;9245590;98334367;-89088777
15/05/2022;41;PR;1974592625;2253767637;-279175012
15/05/2022;26;PE;155979924;745091782;-589111858
15/05/2022;22;PI;167780739;2542743;165237996
15/05/2022;33;RJ;3355395938;1890986066;1464409872
15/05/2022;24;RN;18144981;23838046;-5693065
15/05/2022;43;RS;1616024852;1406318543;209706309
15/05/2022;11;RO;295309594;55386370;239923224
15/05/2022;14;RR;25649741;9408450;16241291
15/05/2022;42;SC;1053724702;2431770663;-1378045961
15/05/2022;35;SP;5610394295;7269399467;-1659005172
15/05/2022;28;SE;4870475;18318904;-13448429
15/05/2022;17;TO;407889568;98401602;309487966
15/06/2022;12;AC;5129968;1305654;3824314
15/06/2022;27;AL;13310565;71107478;-57796913
15/06/2022;16;AP;27185946;10372332;16813614
15/06/2022;13;AM;85013941;1185096393;-1100082452
15/06/2022;29;BA;1410177000;881507160;528669840
15/06/2022;23;CE;364453761;491355531;-126901770
15/06/2022;53;DF;38618856;182444646;-143825790
15/06/2022;32;ES;734207630;1044778283;-310570653
15/06/2022;52;GO;1442376863;600902272;841474591
15/06/2022;21;MA;674579409;758535368;-83955959
15/06/2022;51;MT;3530474055;821683060;2708790995
15/06/2022;50;MS;690406407;297745709;392660698
15/06/2022;31;MG;4295560127;1767714860;2527845267
15/06/2022;15;PA;2126110764;164989013;1961121751
15/06/2022;25;PB;12343276;47615996;-35272720
15/06/2022;41;PR;2139505910;1996163309;143342601
15/06/2022;26;PE;299354904;670179339;-370824435
15/06/2022;22;PI;206855711;10026178;196829533
15/06/2022;33;RJ;4374348527;2286108819;2088239708
15/06/2022;24;RN;134937969;27687287;107250682
15/06/2022;43;RS;1876821440;1262075273;614746167
15/06/2022;11;RO;232578156;56661106;175917050
15/06/2022;14;RR;21893368;859011;21034357
15/06/2022;42;SC;1214013124;2214558570;-1000545446
15/06/2022;35;SP;6355866698;6888097669;-532230971
15/06/2022;28;SE;13826337;26451802;-12625465
15/06/2022;17;TO;346704442;86237002;260467440
15/07/2022;12;AC;3668397;64343;3604054
15/07/2022;27;AL;5447417;57096406;-51648989
15/07/2022;16;AP;15990953;38267201;-22276248
15/07/2022;13;AM;79082627;1002648962;-923566335
15/07/2022;29;BA;1254040617;751266422;502774195
15/07/2022;23;CE;252295380;278941577;-26646197
15/07/2022;53;DF;34741431;161213310;-126471879
15/07/2022;32;ES;749465617;699407396;50058221
15/07/2022;52;GO;1287320419;572100379;715220040
15/07/2022;21;MA;500868521;732519666;-231651145
15/07/2022;51;MT;2713840438;736190332;1977650106
15/07/2022;50;MS;750472745;334154790;416317955
15/07/2022;31;MG;3535489328;1832723018;1702766310
15/07/2022;15;PA;2169083232;278086907;1890996325
15/07/2022;25;PB;13396921;119177405;-105780484
15/07/2022;41;PR;2031328992;2045127434;-13798442
15/07/2022;26;PE;153894280;1026349894;-872455614
15/07/2022;22;PI;176300139;31286554;145013585
15/07/2022;33;RJ;4303548094;1916314803;2387233291
15/07/2022;24;RN;86335538;18113635;68221903
15/07/2022;43;RS;1943842576;1561164965;382677611
15/07/2022;11;RO;203757718;57078522;146679196
15/07/2022;14;RR;22890694;237722;22652972
15/07/2022;42;SC;1149201382;2440955668;-1291754286
15/07/2022;35;SP;6003238864;7658438462;-1655199598
15/07/2022;28;SE;19312901;39485973;-20173072
15/07/2022;17;TO;233455034;98595436;134859598
15/08/2022;12;AC;4563957;439032;4124925
15/08/2022;27;AL;39615451;73645033;-34029582
15/08/2022;16;AP;22826518;93980849;-71154331
15/08/2022;13;AM;85221936;1288681285;-1203459349
15/08/2022;29;BA;1206972093;1080430301;126541792
15/08/2022;23;CE;143529369;437760122;-294230753
15/08/2022;53;DF;31293038;160710922;-129417884
15/08/2022;32;ES;593303321;878626851;-285323530
15/08/2022;52;GO;1242036187;650386941;591649246
15/08/2022;21;MA;607577878;748975750;-141397872
15/08/2022;51;MT;2714528692;582110144;2132418548
15/08/2022;50;MS;709075324;283165438;425909886
15/08/2022;31;MG;3491610253;1681934728;1809675525
15/08/2022;15;PA;2120086213;307847402;1812238811
15/08/2022;25;PB;12742459;79679963;-66937504
15/08/2022;41;PR;2309889571;2086314267;223575304
15/08/2022;26;PE;167582984;679796266;-512213282
15/08/2022;22;PI;181924743;37032477;144892266
15/08/2022;33;RJ;3888192864;2260896239;1627296625
15/08/2022;24;RN;15572665;66055037;-50482372
15/08/2022;43;RS;2258650057;1644809133;613840924
15/08/2022;11;RO;214412567;89589820;124822747
15/08/2022;14;RR;27506933;1810152;25696781
15/08/2022;42;SC;1213466695;2797052524;-1583585829
15/08/2022;35;SP;7064662057;8581934352;-1517272295
15/08/2022;28;SE;7161809;22138988;-14977179
15/08/2022;17;TO;325465932;64422819;261043113
15/09/2022;12;AC;3160484;1388176;1772308
15/09/2022;27;AL;19899118;70071913;-50172795
15/09/2022;16;AP;11648314;131480683;-119832369
15/09/2022;13;AM;82215082;1292301010;-1210085928
15/09/2022;29;BA;1320350898;1342295833;-21944935
15/09/2022;23;CE;153624344;303305966;-149681622
15/09/2022;53;DF;32925099;133334809;-100409710
15/09/2022;32;ES;953240842;763033690;190207152
15/09/2022;52;GO;1149141776;452863661;696278115
15/09/2022;21;MA;540914216;715111447;-174197231
15/09/2022;51;MT;2196801653;576214817;1620586836
15/09/2022;50;MS;726863907;279483710;447380197
15/09/2022;31;MG;3565637564;1571271831;1994365733
15/09/2022;15;PA;2025612718;298122428;1727490290
15/09/2022;25;PB;7847789;68281441;-60433652
15/09/2022;41;PR;1858787487;2160956265;-302168778
15/09/2022;26;PE;123117911;675206669;-552088758
15/09/2022;22;PI;208472191;42311114;166161077
15/09/2022;33;RJ;3523659711;2168249058;1355410653
15/09/2022;24;RN;49081344;35942653;13138691
15/09/2022;43;RS;2089529387;1458145239;631384148
15/09/2022;11;RO;154369437;63258578;91110859
15/09/2022;14;RR;44814764;1258664;43556100
15/09/2022;42;SC;1000139791;2691019257;-1690879466
15/09/2022;35;SP;6291165305;7518346156;-1227180851
15/09/2022;28;SE;20208331;17037497;3170834
15/09/2022;17;TO;300435207;62412702;238022505
15/10/2022;12;AC;2909986;172627;2737359
15/10/2022;27;AL;76860414;81250113;-4389699
15/10/2022;16;AP;11228594;122307693;-111079099
15/10/2022;13;AM;76790868;1160314763;-1083523895
15/10/2022;29;BA;1125035449;749557738;375477711
15/10/2022;23;CE;195704302;333859698;-138155396
15/10/2022;53;DF;29194367;83941165;-54746798
15/10/2022;32;ES;637101283;801383843;-164282560
15/10/2022;52;GO;1060523517;403882893;656640624
15/10/2022;21;MA;466218881;589022753;-122803872
15/10/2022;51;MT;2537105831;423601466;2113504365
15/10/2022;50;MS;718583531;227176341;491407190
15/10/2022;31;MG;3151642825;1513751518;1637891307
15/10/2022;15;PA;1470105665;230465223;1239640442
15/10/2022;25;PB;12096858;71127484;-59030626
15/10/2022;41;PR;2019054378;2162878873;-143824495
15/10/2022;26;PE;197069070;758352294;-561283224
15/10/2022;22;PI;161502851;19297854;142204997
15/10/2022;33;RJ;3312318387;2111009346;1201309041
15/10/2022;24;RN;76365146;37746788;38618358
15/10/2022;43;RS;2006207986;1744127273;262080713
15/10/2022;11;RO;111964867;58843659;53121208
15/10/2022;14;RR;79574322;713568;78860754
15/10/2022;42;SC;931394035;2585906340;-1654512305
15/10/2022;35;SP;5889533938;7154519548;-1264985610
15/10/2022;28;SE;10210173;8461784;1748389
15/10/2022;17;TO;281395358;43432481;237962877
15/11/2022;12;AC;986894;477551;509343
15/11/2022;27;AL;102032717;70490020;31542697
15/11/2022;16;AP;14517924;85759898;-71241974
15/11/2022;13;AM;67219079;1121356884;-1054137805
15/11/2022;29;BA;1182440264;773340244;409100020
15/11/2022;23;CE;145729991;290009507;-144279516
15/11/2022;53;DF;30457924;40352481;-9894557
15/11/2022;32;ES;742830219;904419753;-161589534
15/11/2022;52;GO;927168953;348166867;579002086
15/11/2022;21;MA;372228363;481331199;-109102836
15/11/2022;51;MT;2261913760;330717052;1931196708
15/11/2022;50;MS;589470591;249935395;339535196
15/11/2022;31;MG;3257711701;1420240103;1837471598
15/11/2022;15;PA;1554385826;225893221;1328492605
15/11/2022;25;PB;12663896;67133192;-54469296
15/11/2022;41;PR;1768815119;1598942567;169872552
15/11/2022;26;PE;253392925;502569529;-249176604
15/11/2022;22;PI;114951748;26521603;88430145
15/11/2022;33;RJ;5056138145;2267895271;2788242874
15/11/2022;24;RN;37392305;46863879;-9471574
15/11/2022;43;RS;1962309263;1475115924;487193339
15/11/2022;11;RO;110578626;65979645;44598981
15/11/2022;14;RR;30011624;1114115;28897509
15/11/2022;42;SC;930805945;2584897875;-1654091930
15/11/2022;35;SP;5802369027;6394239003;-591869976
15/11/2022;28;SE;8639019;12156835;-3517816
15/11/2022;17;TO;137150375;66066296;71084079
15/12/2022;12;AC;1314683;170338;1144345
15/12/2022;27;AL;44889083;56182640;-11293557
15/12/2022;16;AP;13097193;130270618;-117173425
15/12/2022;13;AM;82148361;1182258980;-1100110619
15/12/2022;29;BA;1001941522;835627630;166313892
15/12/2022;23;CE;125751733;329777128;-204025395
15/12/2022;53;DF;21108212;368110628;-347002416
15/12/2022;32;ES;700786410;700315791;470619
15/12/2022;52;GO;952741551;424765058;527976493
15/12/2022;21;MA;353959902;507757032;-153797130
15/12/2022;51;MT;2028773749;360200585;1668573164
15/12/2022;50;MS;564631379;264170651;300460728
15/12/2022;31;MG;2836201417;1320922279;1515279138
15/12/2022;15;PA;1436582815;207596291;1228986524
15/12/2022;25;PB;19651110;71003673;-51352563
15/12/2022;41;PR;1502830482;1649824443;-146993961
15/12/2022;26;PE;247597476;726234239;-478636763
15/12/2022;22;PI;83337008;31802891;51534117
15/12/2022;33;RJ;4542339157;2041969778;2500369379
15/12/2022;24;RN;62505414;41258726;21246688
15/12/2022;43;RS;2058088973;1688170363;369918610
15/12/2022;11;RO;93026285;66478360;26547925
15/12/2022;14;RR;45298838;1327979;43970859
15/12/2022;42;SC;899301266;2413226484;-1513925218
15/12/2022;35;SP;6031662160;6307231094;-275568934
15/12/2022;28;SE;6825760;5728195;1097565
15/12/2022;17;TO;197777339;76660772;121116567
15/01/2023;12;AC;1956151;324461;1631690
15/01/2023;27;AL;120627612;49495358;71132254
15/01/2023;16;AP;20549344;36508954;-15959610
15/01/2023;13;AM;74752089;1210265324;-1135513235
15/01/2023;29;BA;731682967;977795595;-246112628
15/01/2023;23;CE;206183938;263787809;-57603871
15/01/2023;53;DF;27791232;497579942;-469788710
15/01/2023;32;ES;587376545;716365070;-128988525
15/01/2023;52;GO;675133997;423732003;251401994
15/01/2023;21;MA;369172979;308435272;60737707
15/01/2023;51;MT;1865615624;202506564;1663109060
15/01/2023;50;MS;578715841;278366896;300348945
15/01/2023;31;MG;2802456396;1176343412;1626112984
15/01/2023;15;PA;1360195804;251478066;1108717738
15/01/2023;25;PB;30619739;58675037;-28055298
15/01/2023;41;PR;1407925529;1382475938;25449591
15/01/2023;26;PE;252267792;651019045;-398751253
15/01/2023;22;PI;94342818;21728011;72614807
15/01/2023;33;RJ;3480452266;1949954434;1530497832
15/01/2023;24;RN;75997166;20896259;55100907
15/01/2023;43;RS;1778956919;1418327605;360629314
15/01/2023;11;RO;104750072;71892386;32857686
15/01/2023;14;RR;23363124;2559611;20803513
15/01/2023;42;SC;850515437;2369761611;-1519246174
15/01/2023;35;SP;5131827956;6135018285;-1003190329
15/01/2023;28;SE;5772544;25047097;-19274553
15/01/2023;17;TO;110014244;28171319;81842925
15/02/2023;12;AC;2179218;246326;1932892
15/02/2023;27;AL;78934049;48510163;30423886
15/02/2023;16;AP;16907759;133240044;-116332285
15/02/2023;13;AM;58862339;981658968;-922796629
15/02/2023;29;BA;800528577;726303128;74225449
15/02/2023;23;CE;169619854;201416903;-31797049
15/02/2023;53;DF;33411512;328879249;-295467737
15/02/2023;32;ES;511725971;558960172;-47234201
15/02/2023;52;GO;737847323;298502271;439345052
15/02/2023;21;MA;238418921;513088322;-274669401
15/02/2023;51;MT;2511864607;151753045;2360111562
15/02/2023;50;MS;475281417;260842575;214438842
15/02/2023;31;MG;2486540106;1114137406;1372402700
15/02/2023;15;PA;1455425975;139868000;1315557975
15/02/2023;25;PB;19046738;90693004;-71646266
15/02/2023;41;PR;1667012767;1411915324;255097443
15/02/2023;26;PE;180804402;507951336;-327146934
15/02/2023;22;PI;37532461;6273417;31259044
15/02/2023;33;RJ;1727400943;1679238190;48162753
15/02/2023;24;RN;35169211;17359797;17809414
15/02/2023;43;RS;1439703239;1029990163;409713076
15/02/2023;11;RO;182846051;58740737;124105314
15/02/2023;14;RR;24367659;3896355;20471304
15/02/2023;42;SC;823838448;2139949203;-1316110755
15/02/2023;35;SP;4369359815;5169316883;-799957068
15/02/2023;28;SE;14948780;14411208;537572
15/02/2023;17;TO;79493875;96354212;-16860337
15/03/2023;12;AC;6221735;810288;5411447
15/03/2023;27;AL;96506994;58974314;37532680
15/03/2023;16;AP;12314219;40889855;-28575636
15/03/2023;13;AM;84227727;1393227216;-1308999489
15/03/2023;29;BA;1028871959;819074137;209797822
15/03/2023;23;CE;123815673;273232138;-149416465
15/03/2023;53;DF;41788074;360691723;-318903649
15/03/2023;32;ES;862575530;842820366;19755164
15/03/2023;52;GO;1475531983;514212300;961319683
15/03/2023;21;MA;527109587;506852582;20257005
15/03/2023;51;MT;3850464107;273875708;3576588399
15/03/2023;50;MS;1028946574;242808921;786137653
15/03/2023;31;MG;3775206793;1323782477;2451424316
15/03/2023;15;PA;1739011121;194380414;1544630707
15/03/2023;25;PB;18590612;57914842;-39324230
15/03/2023;41;PR;2100510998;1724183219;376327779
15/03/2023;26;PE;165674829;670176884;-504502055
15/03/2023;22;PI;120151223;25921736;94229487
15/03/2023;33;RJ;5790288170;2091915802;3698372368
15/03/2023;24;RN;31986322;28602498;3383824
15/03/2023;43;RS;1862846455;1301565424;561281031
15/03/2023;11;RO;398496338;60568262;337928076
15/03/2023;14;RR;25180828;2048638;23132190
15/03/2023;42;SC;998440475;2517662192;-1519221717
15/03/2023;35;SP;6200096213;6711733267;-511637054
15/03/2023;28;SE;47107683;17350522;29757161
15/03/2023;17;TO;248958434;16531206;232427228
15/04/2023;12;AC;7023413;860129;6163284
15/04/2023;27;AL;67616020;59593690;8022330
15/04/2023;16;AP;22947085;70543841;-47596756
15/04/2023;13;AM;106552840;909966818;-803413978
15/04/2023;29;BA;779201888;894909285;-115707397
15/04/2023;23;CE;133128773;255908593;-122779820
15/04/2023;53;DF;29243098;212915265;-183672167
15/04/2023;32;ES;680342145;741020730;-60678585
15/04/2023;52;GO;1399452722;420535644;978917078
15/04/2023;21;MA;456745511;228698111;228047400
15/04/2023;51;MT;3148189357;291769892;2856419465
15/04/2023;50;MS;1081327799;295919892;785407907
15/04/2023;31;MG;3214500163;1247083896;1967416267
15/04/2023;15;PA;1637188422;149381973;1487806449
15/04/2023;25;PB;8831364;81175087;-72343723
15/04/2023;41;PR;2158980321;1469976408;689003913
15/04/2023;26;PE;163251615;494397344;-331145729
15/04/2023;22;PI;197713638;16183060;181530578
15/04/2023;33;RJ;2773760728;2076298669;697462059
15/04/2023;24;RN;43457313;34103388;9353925
15/04/2023;43;RS;1606204731;884026787;722177944
15/04/2023;11;RO;397893271;71081810;326811461
15/04/2023;14;RR;20567210;9647496;10919714
15/04/2023;42;SC;972895253;2295820460;-1322925207
15/04/2023;35;SP;5374912873;5893354691;-518441818
15/04/2023;28;SE;7325197;13272207;-5947010
15/04/2023;17;TO;387345820;22855888;364489932
15/05/2023;12;AC;2609647;221088;2388559
15/05/2023;27;AL;84439166;56019511;28419655
15/05/2023;16;AP;10192491;61897760;-51705269
15/05/2023;13;AM;74804404;1255828333;-1181023929
15/05/2023;29;BA;913858706;686567499;227291207
15/05/2023;23;CE;241791252;311886036;-70094784
15/05/2023;53;DF;36459691;96960293;-60500602
15/05/2023;32;ES;874999535;803614059;71385476
15/05/2023;52;GO;1436333574;368151498;1068182076
15/05/2023;21;MA;547892191;474946872;72945319
15/05/2023;51;MT;3488658710;223611081;3265047629
15/05/2023;50;MS;1186996024;276503640;910492384
15/05/2023;31;MG;4034251413;1491294625;2542956788
15/05/2023;15;PA;1988114576;199551457;1788563119
15/05/2023;25;PB;9061423;89513147;-80451724
15/05/2023;41;PR;2545897726;1660871579;885026147
15/05/2023;26;PE;235130026;646272492;-411142466
15/05/2023;22;PI;182496023;28997982;153498041
15/05/2023;33;RJ;3984386842;2669215816;1315171026
15/05/2023;24;RN;61623485;49551803;12071682
15/05/2023;43;RS;1856368926;1313144146;543224780
15/05/2023;11;RO;261256564;75809240;185447324
15/05/2023;14;RR;25770921;1796462;23974459
15/05/2023;42;SC;1124608482;2485413586;-1360805104
15/05/2023;35;SP;6427928188;6333449939;94478249
15/05/2023;28;SE;8502686;8228056;274630
15/05/2023;17;TO;429402162;19133849;410268313
15/06/2023;12;AC;7710906;298281;7412625
15/06/2023;27;AL;52849577;57958756;-5109179
15/06/2023;16;AP;24250831;72327877;-48077046
15/06/2023;13;AM;78748280;1028112422;-949364142
15/06/2023;29;BA;745211895;635079911;110131984
15/06/2023;23;CE;211513148;322147341;-110634193
15/06/2023;53;DF;23319027;112276777;-88957750
15/06/2023;32;ES;1150253063;713670362;436582701
15/06/2023;52;GO;1253397631;459355853;794041778
15/06/2023;21;MA;515489017;370643405;144845612
15/06/2023;51;MT;3243589085;259231591;2984357494
15/06/2023;50;MS;982158326;219136643;763021683
15/06/2023;31;MG;3202914597;1400601317;1802313280
15/06/2023;15;PA;2082261815;186909166;1895352649
15/06/2023;25;PB;9654132;82782282;-73128150
15/06/2023;41;PR;2273269765;1387194382;886075383
15/06/2023;26;PE;131046198;554569509;-423523311
15/06/2023;22;PI;147870332;53152029;94718303
15/06/2023;33;RJ;2025099083;2368633653;-343534570
15/06/2023;24;RN;17808258;128549728;-110741470
15/06/2023;43;RS;1652363022;946131380;706231642
15/06/2023;11;RO;213526332;66872596;146653736
15/06/2023;14;RR;18154468;769118;17385350
15/06/2023;42;SC;1036345762;2236786764;-1200441002
15/06/2023;35;SP;5673974236;5782842387;-108868151
15/06/2023;28;SE;11154857;41491461;-30336604
15/06/2023;17;TO;327676870;14107816;313569054
